dummyCell,boutLength,boutNo,vep,center,start,end
49175,29,1,6,0,600,629
53188,2,1,6,0,600,602
75483,91,1,6,1,600,691
91557,5,1,6,1,600,605
102648,44,1,6,1,600,644
114048,39,1,6,1,600,639
79440,43,1,6,1,601,644
6980,3,1,6,0,602,605
13661,26,1,6,0,602,628
28310,26,1,6,0,602,628
43290,26,1,6,0,602,628
70593,26,1,6,0,602,628
79617,26,1,6,0,602,628
100819,26,1,6,0,602,628
120295,26,1,6,0,602,628
22137,25,1,6,0,603,628
33753,23,1,6,0,603,626
9791,22,1,6,0,604,626
13575,21,1,6,0,604,625
57738,13,1,6,0,604,617
91573,22,1,6,0,604,626
98575,23,1,6,0,604,627
126620,22,1,6,0,604,626
7444,12,1,6,0,605,617
7540,20,1,6,0,605,625
8595,20,1,6,0,605,625
12919,20,1,6,0,605,625
14177,20,1,6,0,605,625
20163,20,1,6,0,605,625
20546,20,1,6,0,605,625
20699,20,1,6,0,605,625
22139,20,1,6,0,605,625
26231,21,1,6,0,605,626
27323,20,1,6,0,605,625
28708,11,1,6,0,605,616
32086,20,1,6,0,605,625
32753,20,1,6,0,605,625
33943,20,1,6,0,605,625
34273,9,1,6,0,605,614
37499,20,1,6,0,605,625
38404,11,1,6,0,605,616
42168,20,1,6,0,605,625
42485,20,1,6,0,605,625
43342,20,1,6,0,605,625
44795,20,1,6,0,605,625
45638,20,1,6,0,605,625
45894,20,1,6,0,605,625
49856,20,1,6,0,605,625
49971,20,1,6,0,605,625
52658,20,1,6,0,605,625
54356,20,1,6,0,605,625
54431,20,1,6,0,605,625
54650,20,1,6,0,605,625
55237,2,1,6,0,605,607
57732,20,1,6,0,605,625
58338,22,1,6,0,605,627
62277,20,1,6,0,605,625
62609,20,1,6,0,605,625
63483,20,1,6,0,605,625
65649,20,1,6,0,605,625
68146,20,1,6,0,605,625
68758,20,1,6,0,605,625
69803,20,1,6,0,605,625
71266,20,1,6,0,605,625
71285,20,1,6,0,605,625
73223,20,1,6,0,605,625
73622,20,1,6,0,605,625
77008,20,1,6,0,605,625
80472,20,1,6,0,605,625
85726,20,1,6,0,605,625
85756,12,1,6,0,605,617
88010,20,1,6,0,605,625
90616,20,1,6,0,605,625
92253,20,1,6,0,605,625
92400,20,1,6,0,605,625
93712,20,1,6,0,605,625
95304,2,1,6,0,605,607
95345,12,1,6,0,605,617
97604,20,1,6,0,605,625
105434,20,1,6,0,605,625
107697,20,1,6,0,605,625
111399,20,1,6,0,605,625
111703,20,1,6,0,605,625
111830,20,1,6,0,605,625
113073,20,1,6,0,605,625
115155,20,1,6,0,605,625
121934,20,1,6,0,605,625
122282,20,1,6,0,605,625
126210,20,1,6,0,605,625
16595,26,1,6,1,606,632
54288,9,1,6,0,606,615
55899,26,1,6,1,606,632
71282,16,1,6,1,606,622
90664,10,1,6,0,606,616
95370,96,1,6,0,606,702
95658,18,1,6,0,606,624
13648,9,1,6,0,607,616
20100,17,1,6,0,607,624
25463,18,1,6,0,607,625
32191,17,1,6,0,607,624
47511,17,1,6,0,607,624
50432,17,1,6,0,607,624
63130,17,1,6,0,607,624
68533,17,1,6,0,607,624
74270,17,1,6,0,607,624
74647,17,1,6,0,607,624
77642,17,1,6,0,607,624
79590,19,1,6,0,607,626
82831,17,1,6,0,607,624
83147,10,1,6,0,607,617
88272,17,1,6,0,607,624
88436,17,1,6,0,607,624
99216,19,1,6,0,607,626
99415,17,1,6,0,607,624
102065,17,1,6,0,607,624
103624,9,1,6,0,607,616
106071,17,1,6,0,607,624
109856,9,1,6,0,607,616
119704,17,1,6,0,607,624
121654,17,1,6,0,607,624
111452,17,1,6,0,608,625
52519,16,1,6,0,609,625
6302,20,1,6,0,610,630
14471,15,1,6,0,610,625
28426,13,1,6,0,611,624
44942,19,1,6,0,611,630
52747,17,1,6,0,612,629
116969,12,1,6,0,612,624
6686,12,1,6,0,613,625
73789,15,1,6,0,613,628
95869,15,1,6,0,613,628
103605,4,1,6,0,613,617
105752,14,1,6,0,613,627
118805,15,1,6,0,613,628
13019,28,1,6,0,614,642
36823,13,1,6,0,614,627
39448,3,1,6,0,614,617
47089,19,1,6,1,614,633
52520,3,1,6,0,614,617
73454,13,1,6,0,614,627
84274,13,1,6,0,614,627
86766,13,1,6,0,614,627
125846,13,1,6,0,614,627
8609,11,1,6,0,615,626
14949,11,1,6,0,615,626
41974,11,1,6,0,615,626
47475,11,1,6,0,615,626
71573,2,1,6,0,615,617
76879,11,1,6,0,615,626
86704,10,1,6,0,615,625
92170,11,1,6,0,615,626
92302,9,1,6,0,615,624
127350,11,1,6,0,615,626
7261,8,1,6,0,616,624
10731,9,1,6,0,616,625
16175,9,1,6,0,616,625
23008,9,1,6,0,616,625
24797,9,1,6,0,616,625
26749,9,1,6,0,616,625
29422,9,1,6,0,616,625
39928,7,1,6,0,616,623
53657,9,1,6,0,616,625
55803,9,1,6,0,616,625
57533,9,1,6,0,616,625
63364,8,1,6,0,616,624
88445,9,1,6,0,616,625
96467,106,1,6,1,616,722
121288,9,1,6,0,616,625
9059,8,1,6,0,617,625
12687,7,1,6,0,617,624
16408,8,1,6,0,617,625
16604,7,1,6,0,617,624
17915,8,1,6,0,617,625
26987,7,1,6,0,617,624
35588,8,1,6,0,617,625
39560,8,1,6,0,617,625
46760,8,1,6,0,617,625
47525,7,1,6,0,617,624
49738,7,1,6,0,617,624
49986,7,1,6,0,617,624
52288,8,1,6,0,617,625
56860,8,1,6,0,617,625
57568,7,1,6,0,617,624
62365,8,1,6,0,617,625
67744,8,1,6,0,617,625
68180,8,1,6,0,617,625
69120,8,1,6,0,617,625
69322,8,1,6,0,617,625
69743,8,1,6,0,617,625
69997,8,1,6,0,617,625
73009,7,1,6,0,617,624
73142,7,1,6,0,617,624
76409,8,1,6,0,617,625
78603,8,1,6,0,617,625
79675,7,1,6,0,617,624
81474,7,1,6,0,617,624
83393,7,1,6,0,617,624
99984,7,1,6,0,617,624
108310,7,1,6,0,617,624
109919,7,1,6,0,617,624
111374,7,1,6,0,617,624
112829,8,1,6,0,617,625
115141,8,1,6,0,617,625
115306,7,1,6,0,617,624
115347,7,1,6,0,617,624
121570,7,1,6,0,617,624
126710,8,1,6,0,617,625
129748,8,1,6,0,617,625
9723,4,1,6,0,618,622
62918,4,1,6,0,618,622
70429,3,1,6,0,619,622
104612,24,1,6,1,622,646
56298,76,1,6,0,623,699
65678,76,1,6,0,623,699
52520,3,2,6,0,624,627
71573,2,2,6,0,624,626
6980,3,2,6,0,625,628
11043,7,1,6,0,625,632
14555,74,1,6,0,625,699
32907,7,1,6,0,625,632
34273,2,2,6,0,625,627
39448,5,2,6,0,625,630
52288,5,2,6,0,625,630
91557,19,2,6,1,625,644
95988,7,1,6,0,625,632
103605,3,2,6,0,625,628
108087,7,1,6,0,625,632
109175,74,1,6,0,625,699
111107,7,1,6,0,625,632
123984,7,1,6,0,625,632
55836,17,1,6,0,628,645
94672,22,1,6,0,628,650
9059,6,2,6,0,630,636
10731,17,2,6,0,630,647
16408,6,2,6,0,630,636
17915,6,2,6,0,630,636
35588,6,2,6,0,630,636
39560,6,2,6,0,630,636
46760,17,2,6,0,630,647
56860,7,2,6,0,630,637
58416,2,1,6,1,630,632
62365,6,2,6,0,630,636
68180,27,2,6,0,630,657
69120,17,2,6,0,630,647
69322,6,2,6,0,630,636
69743,6,2,6,0,630,636
69997,7,2,6,0,630,637
76409,6,2,6,0,630,636
78603,17,2,6,0,630,647
79590,5,2,6,0,630,635
83147,6,2,6,0,630,636
86704,17,2,6,0,630,647
95304,5,2,6,0,630,635
99216,5,2,6,0,630,635
99984,18,2,6,0,630,648
103605,6,3,6,0,630,636
112829,27,2,6,0,630,657
115141,6,2,6,0,630,636
121849,6,1,6,0,630,636
129748,6,2,6,0,630,636
126710,4,2,6,0,631,635
28868,4,1,6,0,632,636
39448,4,3,6,0,632,636
52288,4,3,6,0,632,636
59962,50,1,6,1,632,682
71282,13,2,6,1,632,645
121222,6,1,6,1,632,638
33827,19,1,6,1,633,652
77628,51,1,6,1,633,684
89966,53,1,6,0,633,686
11736,47,1,6,0,634,681
48376,14,1,6,0,634,648
48761,19,1,6,0,634,653
89023,14,1,6,0,634,648
13144,9,1,6,0,635,644
23699,7,1,6,0,635,642
89186,46,1,6,0,635,681
94943,47,1,6,0,635,682
18015,81,1,6,1,636,717
60651,9,1,6,1,636,645
111107,8,2,6,0,636,644
115633,25,1,6,0,636,661
7261,11,2,6,0,637,648
8837,19,1,6,0,637,656
32165,10,1,6,0,637,647
57738,11,2,6,0,637,648
62918,10,2,6,0,637,647
68155,14,1,6,0,637,651
81948,8,1,6,1,637,645
89222,16,1,6,0,637,653
92253,18,2,6,0,637,655
92302,10,2,6,0,637,647
94379,18,1,6,0,637,655
98984,16,1,6,0,637,653
101590,16,1,6,0,637,653
117206,45,1,6,1,637,682
7444,9,2,6,0,638,647
9127,13,1,6,0,638,651
47089,7,2,6,1,638,645
49638,24,1,6,1,638,662
52288,7,4,6,0,638,645
53188,41,2,6,0,638,679
68399,19,1,6,0,638,657
88767,17,1,6,0,638,655
95941,19,1,6,0,638,657
96086,19,1,6,0,638,657
102931,10,1,6,0,638,648
103624,19,2,6,0,638,657
106967,19,1,6,0,638,657
109450,19,1,6,0,638,657
109856,19,2,6,0,638,657
115890,19,1,6,0,638,657
126240,19,1,6,0,638,657
9460,9,1,6,0,639,648
13748,39,1,6,0,639,678
41808,15,1,6,0,639,654
55315,15,1,6,0,639,654
70582,37,1,6,0,639,676
91783,39,1,6,0,639,678
98175,15,1,6,0,639,654
35337,2,1,6,0,640,642
54288,4,2,6,0,640,644
33753,9,2,6,0,641,650
37191,8,1,6,0,641,649
117309,15,1,6,0,641,656
16197,52,1,6,0,642,694
43462,13,1,6,0,642,655
65753,57,1,6,0,642,699
94744,21,1,6,0,642,663
105742,64,1,6,0,642,706
122214,35,1,6,0,642,677
7800,24,1,6,0,643,667
13648,14,2,6,0,643,657
21518,4,1,6,0,643,647
28708,38,2,6,0,643,681
29422,14,2,6,0,643,657
70680,33,1,6,0,643,676
83168,38,1,6,0,643,681
96490,7,1,6,0,643,650
98207,4,1,6,0,643,647
106071,9,2,6,0,643,652
110456,7,1,6,0,643,650
123605,33,1,6,0,643,676
20100,7,2,6,0,644,651
24724,18,1,6,0,644,662
32191,7,2,6,0,644,651
47511,7,2,6,0,644,651
50432,7,2,6,0,644,651
50679,48,1,6,0,644,692
63130,7,2,6,0,644,651
68533,7,2,6,0,644,651
68758,4,2,6,0,644,648
74647,7,2,6,0,644,651
82831,7,2,6,0,644,651
83147,7,3,6,0,644,651
88272,7,2,6,0,644,651
88436,7,2,6,0,644,651
94626,7,1,6,0,644,651
99415,7,2,6,0,644,651
102065,7,2,6,0,644,651
119704,7,2,6,0,644,651
120751,6,1,6,1,644,650
121654,7,2,6,0,644,651
129302,14,1,6,1,644,658
6980,3,3,6,0,645,648
7707,46,1,6,0,645,691
7994,21,1,6,0,645,666
9842,63,1,6,1,645,708
11043,52,2,6,0,645,697
19607,46,1,6,0,645,691
25726,46,1,6,0,645,691
29072,46,1,6,0,645,691
32907,42,2,6,0,645,687
51827,46,1,6,0,645,691
58065,46,1,6,0,645,691
69722,3,1,6,0,645,648
74056,46,1,6,0,645,691
92006,46,1,6,0,645,691
95988,52,2,6,0,645,697
103154,3,1,6,0,645,648
105943,46,1,6,0,645,691
108087,52,2,6,0,645,697
111102,46,1,6,0,645,691
119799,4,1,6,0,645,649
121920,18,1,6,0,645,663
122831,37,1,6,0,645,682
123984,52,2,6,0,645,697
124367,46,1,6,0,645,691
124868,46,1,6,0,645,691
126852,39,1,6,0,645,684
129828,46,1,6,0,645,691
6703,44,1,6,0,646,690
7909,24,1,6,0,647,671
38265,20,1,6,0,647,667
55899,5,2,6,1,647,652
103881,24,1,6,0,647,671
106008,56,1,6,0,647,703
120090,5,1,6,0,647,652
5510,18,1,6,0,648,666
7359,18,1,6,0,648,666
10030,18,1,6,0,648,666
11882,18,1,6,0,648,666
12369,18,1,6,0,648,666
13974,18,1,6,0,648,666
14832,18,1,6,0,648,666
15192,43,1,6,0,648,691
16248,18,1,6,0,648,666
17420,13,1,6,0,648,661
18335,18,1,6,0,648,666
21570,18,1,6,0,648,666
24704,18,1,6,0,648,666
28198,18,1,6,0,648,666
29910,18,1,6,0,648,666
34273,33,3,6,0,648,681
38582,18,1,6,0,648,666
39063,18,1,6,0,648,666
40036,18,1,6,0,648,666
40915,18,1,6,0,648,666
41256,46,1,6,0,648,694
42149,18,1,6,0,648,666
43092,18,1,6,0,648,666
44520,18,1,6,0,648,666
44937,18,1,6,0,648,666
46597,18,1,6,0,648,666
49743,18,1,6,0,648,666
50021,18,1,6,0,648,666
51179,33,1,6,0,648,681
51326,18,1,6,0,648,666
52983,18,1,6,0,648,666
53822,37,1,6,0,648,685
54713,18,1,6,0,648,666
57655,33,1,6,0,648,681
57732,18,2,6,0,648,666
69379,18,1,6,0,648,666
70777,18,1,6,0,648,666
74122,18,1,6,0,648,666
75899,18,1,6,0,648,666
76091,18,1,6,0,648,666
80854,37,1,6,0,648,685
85346,24,1,6,0,648,672
89693,18,1,6,0,648,666
94037,18,1,6,0,648,666
95430,28,1,6,0,648,676
99069,32,1,6,0,648,680
104276,18,1,6,0,648,666
105206,18,1,6,0,648,666
105887,18,1,6,0,648,666
106119,33,1,6,0,648,681
106307,18,1,6,0,648,666
106590,18,1,6,0,648,666
107449,18,1,6,0,648,666
107806,37,1,6,0,648,685
108107,46,1,6,0,648,694
108520,18,1,6,0,648,666
109481,18,1,6,0,648,666
110132,18,1,6,0,648,666
111682,18,1,6,0,648,666
111750,18,1,6,0,648,666
111784,18,1,6,0,648,666
111786,28,1,6,0,648,676
112459,18,1,6,0,648,666
113604,18,1,6,0,648,666
122144,9,1,6,0,648,657
124696,18,1,6,0,648,666
7515,38,1,6,0,649,687
8202,38,1,6,0,649,687
11435,25,1,6,1,649,674
17689,38,1,6,0,649,687
20603,38,1,6,0,649,687
25772,18,1,6,0,649,667
35716,19,1,6,0,649,668
37647,38,1,6,0,649,687
55108,5,1,6,0,649,654
59830,38,1,6,0,649,687
63179,38,1,6,0,649,687
67442,38,1,6,0,649,687
88463,38,1,6,0,649,687
102284,8,1,6,0,649,657
113113,38,1,6,0,649,687
116404,38,1,6,0,649,687
118376,38,1,6,0,649,687
118637,13,1,6,0,649,662
24701,18,1,6,0,650,668
41068,18,1,6,0,650,668
41698,18,1,6,0,650,668
58005,18,1,6,0,650,668
59251,19,1,6,0,650,669
60651,2,2,6,1,650,652
73053,7,1,6,0,650,657
89383,18,1,6,0,650,668
93598,18,1,6,0,650,668
111479,15,1,6,0,650,665
116318,18,1,6,0,650,668
116699,34,1,6,0,650,684
118169,13,1,6,0,650,663
125134,18,1,6,0,650,668
52613,20,1,6,1,651,671
80788,11,1,6,0,651,662
87815,19,1,6,0,651,670
122516,11,1,6,0,651,662
16595,9,2,6,0,652,661
23202,40,1,6,1,652,692
35204,49,1,6,0,652,701
35337,3,2,6,0,652,655
53341,16,1,6,0,652,668
58416,8,2,6,1,652,660
63725,50,1,6,0,652,702
71282,65,3,6,1,652,717
118986,50,1,6,0,652,702
13653,8,1,6,0,653,661
14844,3,1,6,0,653,656
17115,8,1,6,0,653,661
64322,13,1,6,0,653,666
67869,8,1,6,0,653,661
80738,13,1,6,0,653,666
81948,11,2,6,1,653,664
108834,13,1,6,0,653,666
111107,10,3,6,0,653,663
111374,12,2,6,0,653,665
113882,13,1,6,0,653,666
114535,13,1,6,0,653,666
115630,13,1,6,0,653,666
6838,13,1,6,0,654,667
9460,7,2,6,0,654,661
23699,5,2,6,0,654,659
48617,10,1,6,0,654,664
51706,9,1,6,0,654,663
57044,10,1,6,0,654,664
13144,11,2,6,0,655,666
30613,40,1,6,0,655,695
50643,44,1,6,0,655,699
54134,44,1,6,0,655,699
60080,15,1,6,0,655,670
89545,44,1,6,0,655,699
102628,14,1,6,1,655,669
117070,10,1,6,0,655,665
13587,7,1,6,0,656,663
27059,7,1,6,0,656,663
37499,19,2,6,0,656,675
49698,7,1,6,0,656,663
55382,8,1,6,0,656,664
57568,7,2,6,0,656,663
63406,7,1,6,0,656,663
76152,12,1,6,1,656,668
114868,7,1,6,0,656,663
119820,7,1,6,0,656,663
123101,7,1,6,0,656,663
10316,11,1,6,1,657,668
15966,5,1,6,0,657,662
16629,5,1,6,0,657,662
17633,5,1,6,0,657,662
54288,7,3,6,0,657,664
57722,5,1,6,0,657,662
89869,5,1,6,0,657,662
95570,5,1,6,0,657,662
98405,5,1,6,0,657,662
102931,6,2,6,0,657,663
113937,5,1,6,0,657,662
124093,8,1,6,0,657,665
30817,4,1,6,0,658,662
33753,17,3,6,0,658,675
63261,8,1,6,0,658,666
85995,3,1,6,0,658,661
94626,19,2,6,0,658,677
55108,22,2,6,0,659,681
35337,3,3,6,0,660,663
54883,8,1,6,0,660,668
95008,15,1,6,0,660,675
41808,20,2,6,0,661,681
55315,20,2,6,0,661,681
98175,6,2,6,0,661,667
125611,10,1,6,0,661,671
11094,9,1,6,0,662,671
43462,39,2,6,0,662,701
97604,9,2,6,0,662,671
117309,28,2,6,0,662,690
122144,4,2,6,0,662,666
8837,4,2,6,0,663,667
13347,11,1,6,0,663,674
14844,3,2,6,0,663,666
60651,4,3,6,1,663,667
68180,13,3,6,0,663,676
68399,15,2,6,0,663,678
95941,15,2,6,0,663,678
103624,34,3,6,0,663,697
106967,15,2,6,0,663,678
109450,15,2,6,0,663,678
109856,17,3,6,0,663,680
112829,14,3,6,0,663,677
115890,15,2,6,0,663,678
126240,15,2,6,0,663,678
9127,14,2,6,0,664,678
9670,36,1,6,0,664,700
13143,36,1,6,0,664,700
13648,14,3,6,0,664,678
26791,26,1,6,0,664,690
29422,14,3,6,0,664,678
63401,23,1,6,0,664,687
68155,14,2,6,0,664,678
89222,14,2,6,0,664,678
90664,36,2,6,0,664,700
92253,14,3,6,0,664,678
94379,14,2,6,0,664,678
96490,14,2,6,0,664,678
98984,14,2,6,0,664,678
101486,3,1,6,0,664,667
101590,14,2,6,0,664,678
108159,60,1,6,1,664,724
110456,14,2,6,0,664,678
110650,36,1,6,0,664,700
120832,36,1,6,0,664,700
121987,57,1,6,1,664,721
12687,32,2,6,0,665,697
16604,32,2,6,0,665,697
32191,32,3,6,0,665,697
38486,15,1,6,0,665,680
39352,13,1,6,0,665,678
46760,10,3,6,0,665,675
48294,21,1,6,0,665,686
49738,16,2,6,0,665,681
57492,21,1,6,0,665,686
66899,23,1,6,0,665,688
69023,21,1,6,0,665,686
69120,10,3,6,0,665,675
78603,10,3,6,0,665,675
82831,32,3,6,0,665,697
99984,13,3,6,0,665,678
102284,29,2,6,0,665,694
106071,17,3,6,0,665,682
108947,14,1,6,0,665,679
121654,32,3,6,0,665,697
6980,8,4,6,0,666,674
7261,8,3,6,0,666,674
9460,8,3,6,0,666,674
32165,8,2,6,0,666,674
42130,29,1,6,0,666,695
48761,9,2,6,0,666,675
62918,8,3,6,0,666,674
69330,3,1,6,0,666,669
70429,8,2,6,0,666,674
89023,8,2,6,0,666,674
92302,8,3,6,0,666,674
95023,11,1,6,0,666,677
100838,16,1,6,0,666,682
102931,8,3,6,0,666,674
103154,8,2,6,0,666,674
111107,6,4,6,0,666,672
111374,9,3,6,0,666,675
122516,14,2,6,0,666,680
129302,2,2,6,1,666,668
9723,30,2,6,0,667,697
19170,30,1,6,0,667,697
20100,30,3,6,0,667,697
26265,30,1,6,0,667,697
44911,30,1,6,0,667,697
47511,30,3,6,0,667,697
50432,30,3,6,0,667,697
52892,30,1,6,0,667,697
55297,30,1,6,0,667,697
59415,30,1,6,0,667,697
63130,30,3,6,0,667,697
68533,30,3,6,0,667,697
68714,30,1,6,0,667,697
74647,30,3,6,0,667,697
83147,30,4,6,0,667,697
88272,12,3,6,0,667,679
88436,30,3,6,0,667,697
92264,30,1,6,0,667,697
99415,30,3,6,0,667,697
100574,30,1,6,0,667,697
102065,30,3,6,0,667,697
119704,30,3,6,0,667,697
124914,30,1,6,0,667,697
107378,16,1,6,0,668,684
118053,16,1,6,0,668,684
59254,16,1,6,0,669,685
82531,15,1,6,0,671,686
96086,7,2,6,0,671,678
115060,11,1,6,0,672,683
124093,40,2,6,0,672,712
7994,34,2,6,0,673,707
14844,3,3,6,0,673,676
23699,28,3,6,0,673,701
54883,22,2,6,0,673,695
64322,37,2,6,0,673,710
80738,34,2,6,0,673,707
108834,37,2,6,0,673,710
114535,37,2,6,0,673,710
5510,15,2,6,0,674,689
7359,15,2,6,0,674,689
10030,15,2,6,0,674,689
11882,15,2,6,0,674,689
12369,15,2,6,0,674,689
13974,15,2,6,0,674,689
14832,15,2,6,0,674,689
16248,15,2,6,0,674,689
18335,15,2,6,0,674,689
20377,16,1,6,0,674,690
21570,15,2,6,0,674,689
24704,15,2,6,0,674,689
24724,15,2,6,0,674,689
28198,15,2,6,0,674,689
29910,15,2,6,0,674,689
38582,15,2,6,0,674,689
39063,15,2,6,0,674,689
40036,15,2,6,0,674,689
40915,15,2,6,0,674,689
42149,15,2,6,0,674,689
43092,15,2,6,0,674,689
44520,15,2,6,0,674,689
44937,15,2,6,0,674,689
46597,15,2,6,0,674,689
47054,26,1,6,0,674,700
49743,15,2,6,0,674,689
50021,15,2,6,0,674,689
51326,15,2,6,0,674,689
51706,31,2,6,0,674,705
51880,6,1,6,0,674,680
52983,15,2,6,0,674,689
54713,15,2,6,0,674,689
57732,9,3,6,0,674,683
69379,15,2,6,0,674,689
70777,15,2,6,0,674,689
74122,15,2,6,0,674,689
75899,15,2,6,0,674,689
76091,15,2,6,0,674,689
89693,15,2,6,0,674,689
94037,15,2,6,0,674,689
104276,15,2,6,0,674,689
105206,15,2,6,0,674,689
105887,15,2,6,0,674,689
106307,15,2,6,0,674,689
106590,15,2,6,0,674,689
107449,15,2,6,0,674,689
108520,15,2,6,0,674,689
109481,15,2,6,0,674,689
110132,15,2,6,0,674,689
111682,15,2,6,0,674,689
111750,15,2,6,0,674,689
111784,15,2,6,0,674,689
112459,15,2,6,0,674,689
113604,15,2,6,0,674,689
118637,25,2,6,0,674,699
122144,4,3,6,0,674,678
124696,15,2,6,0,674,689
16057,21,1,6,0,675,696
33827,4,2,6,1,675,679
38979,108,1,7,0,675,783
49758,20,1,6,0,675,695
57673,20,1,6,0,675,695
113882,35,2,6,0,675,710
114868,32,2,6,0,675,707
120315,17,1,6,0,675,692
120361,39,1,6,0,675,714
11016,20,1,6,0,676,696
13587,31,2,6,0,676,707
21302,3,1,6,1,676,679
27059,6,2,6,0,676,682
49698,31,2,6,0,676,707
63406,25,2,6,0,676,701
76649,26,1,6,0,676,702
119820,31,2,6,0,676,707
123101,31,2,6,0,676,707
24118,7,1,6,0,677,684
30398,15,1,6,0,677,692
35337,2,4,6,0,677,679
46602,18,1,6,0,677,695
87403,23,1,6,1,677,700
8837,11,3,6,0,678,689
9721,14,1,6,0,678,692
15966,29,2,6,0,678,707
16629,29,2,6,0,678,707
17633,3,2,6,0,678,681
39491,9,1,6,0,678,687
43347,14,1,6,0,678,692
53356,9,1,6,0,678,687
57722,29,2,6,0,678,707
81948,11,3,6,1,678,689
85995,23,2,6,0,678,701
88767,18,2,6,0,678,696
89869,29,2,6,0,678,707
91340,17,1,6,0,678,695
95570,29,2,6,0,678,707
98405,29,2,6,0,678,707
102931,11,4,6,0,678,689
110296,4,1,6,0,678,682
113937,29,2,6,0,678,707
129302,2,3,6,1,678,680
10316,18,2,6,1,679,697
23524,8,1,6,0,679,687
34100,22,1,6,0,679,701
37763,18,1,6,0,679,697
43600,17,1,6,0,679,696
54288,3,4,6,0,679,682
57568,21,3,6,0,679,700
82733,8,1,6,0,679,687
84452,12,1,6,0,679,691
91202,21,1,6,0,679,700
101352,2,1,6,0,679,681
102628,18,2,6,1,679,697
105389,8,1,6,0,679,687
106665,19,1,6,0,679,698
108820,8,1,6,0,679,687
117070,9,2,6,0,679,688
7800,20,2,6,0,680,700
39560,11,3,6,1,680,691
52288,10,5,6,0,680,690
56463,18,1,6,0,680,698
59921,12,1,6,0,680,692
74235,10,1,6,0,680,690
85143,12,1,6,0,680,692
95304,12,3,6,0,680,692
129069,13,1,6,0,680,693
9423,11,1,6,0,681,692
9460,8,4,6,0,681,689
11509,12,1,6,0,681,693
38404,13,2,6,0,681,694
40482,13,1,6,0,681,694
45670,14,1,6,0,681,695
48617,15,2,6,0,681,696
59027,11,1,6,0,681,692
60816,10,1,6,0,681,691
62411,12,1,6,0,681,693
69330,15,2,6,0,681,696
76879,12,2,6,0,681,693
91171,11,1,6,0,681,692
98175,10,3,6,0,681,691
106574,14,1,6,0,681,695
23400,10,1,6,0,682,692
41662,12,1,6,0,682,694
48761,3,3,6,0,682,685
59451,21,1,6,0,682,703
67949,15,1,6,0,682,697
84377,11,1,6,0,682,693
86137,12,1,6,0,682,694
89023,3,3,6,0,682,685
90642,14,1,6,0,682,696
92583,9,1,6,0,682,691
97036,15,1,6,0,682,697
99984,15,4,6,0,682,697
25598,4,1,6,0,683,687
38084,4,1,6,0,683,687
38265,14,2,6,0,683,697
57044,17,2,6,0,683,700
58361,12,1,6,0,683,695
74586,4,1,6,0,683,687
110418,4,1,6,0,683,687
13302,7,1,6,0,684,691
51880,17,2,6,0,684,701
92400,7,2,6,0,684,691
94346,8,1,6,0,684,692
118822,24,1,6,1,684,708
120956,8,1,6,0,684,692
48376,16,2,6,0,685,701
54288,4,5,6,0,685,689
94943,16,2,6,0,685,701
95430,10,2,6,0,685,695
127526,31,1,6,1,685,716
26146,4,1,6,0,686,690
30451,4,1,6,0,686,690
46290,4,1,6,0,686,690
89186,20,2,6,0,686,706
118551,15,1,6,0,686,701
122831,5,2,6,0,686,691
37960,2,1,6,0,687,689
90574,7,1,6,0,687,694
109856,10,4,6,0,687,697
111786,7,2,6,0,687,694
112829,10,4,6,0,687,697
123271,13,1,6,1,687,700
28708,19,3,6,0,688,707
64394,15,1,6,0,688,703
83168,13,2,6,0,688,701
101486,12,2,6,0,688,700
6980,2,5,6,0,689,691
13648,8,4,6,0,689,697
21336,14,1,6,0,689,703
29422,8,4,6,0,689,697
46760,8,4,6,0,689,697
53188,8,3,6,0,689,697
57732,8,4,6,0,689,697
58744,14,1,6,0,689,703
68155,8,3,6,0,689,697
68180,8,4,6,0,689,697
68399,8,3,6,0,689,697
69120,8,4,6,0,689,697
78603,8,4,6,0,689,697
89023,12,4,6,0,689,701
89222,8,3,6,0,689,697
92253,8,4,6,0,689,697
94379,8,3,6,0,689,697
95941,8,3,6,0,689,697
96086,8,3,6,0,689,697
98984,8,3,6,0,689,697
101590,8,3,6,0,689,697
102931,8,5,6,0,689,697
103154,2,3,6,0,689,691
106967,8,3,6,0,689,697
109450,8,3,6,0,689,697
110296,6,2,6,0,689,695
113912,14,1,6,0,689,703
115890,8,3,6,0,689,697
122144,18,4,6,0,689,707
126240,8,3,6,0,689,697
9127,6,3,6,0,690,696
28991,9,1,6,0,690,699
62040,9,1,6,0,690,699
90264,9,1,6,0,690,699
25772,6,2,6,0,691,697
27971,8,1,6,0,691,699
33753,19,4,6,0,691,710
35337,10,5,6,0,691,701
41808,9,3,6,0,691,700
55899,6,3,6,1,691,697
60067,12,1,6,0,691,703
88272,6,4,6,0,691,697
98575,7,2,6,0,691,698
121920,8,2,6,0,691,699
9460,7,5,6,0,692,699
17633,15,3,6,0,692,707
33827,39,3,7,1,692,731
55315,7,3,6,0,692,699
128416,11,1,6,0,692,703
11736,8,2,6,0,693,701
13287,3,1,6,0,693,696
13728,3,1,6,0,693,696
21518,16,2,6,0,693,709
22137,17,2,6,0,693,710
33967,6,1,6,0,693,699
77753,3,1,6,0,693,696
85756,7,2,6,0,693,700
98207,16,2,6,0,693,709
103311,3,1,6,0,693,696
120751,7,2,6,1,693,700
128576,8,1,6,0,693,701
13748,5,2,6,0,694,699
27059,13,3,6,0,694,707
68972,2,1,6,0,694,696
73789,17,2,6,0,694,711
117309,7,3,6,0,694,701
31655,16,1,6,0,695,711
33417,16,1,6,0,695,711
49738,2,3,6,0,695,697
52111,12,1,6,0,695,707
67376,4,1,6,0,695,699
103605,6,4,6,0,695,701
122516,2,3,6,0,695,697
12922,12,1,6,0,696,708
28426,11,2,6,0,696,707
39928,16,2,6,0,696,712
49175,15,2,6,0,696,711
52747,16,2,6,0,696,712
58338,14,2,6,0,696,710
65615,12,1,6,0,696,708
89576,14,1,6,0,696,710
118805,15,2,6,0,696,711
120315,15,2,6,0,696,711
121288,12,2,6,0,696,708
125846,14,2,6,0,696,710
129069,3,2,6,0,696,699
6980,3,6,6,0,697,700
7261,10,4,6,0,697,707
10731,10,3,6,0,697,707
13661,13,2,6,0,697,710
21482,14,1,6,0,697,711
28310,13,2,6,0,697,710
32165,10,3,6,0,697,707
43290,13,2,6,0,697,710
54288,4,6,6,0,697,701
60947,14,1,6,0,697,711
62918,10,4,6,0,697,707
65196,13,1,6,0,697,710
70593,13,2,6,0,697,710
73454,13,2,6,0,697,710
79617,13,2,6,0,697,710
81948,11,4,6,1,697,708
86704,10,3,6,0,697,707
86766,13,2,6,0,697,710
91557,3,3,6,1,697,700
92302,10,4,6,0,697,707
95869,14,2,6,0,697,711
98175,3,4,6,0,697,700
100819,13,2,6,0,697,710
105752,9,2,6,1,697,706
111374,13,4,6,0,697,710
120295,13,2,6,0,697,710
14949,11,2,6,0,698,709
24797,10,2,6,0,698,708
34273,2,4,6,0,698,700
36823,12,2,6,0,698,710
41974,11,2,6,0,698,709
47475,11,2,6,0,698,709
49971,2,2,6,0,698,700
52520,3,3,6,0,698,701
71573,4,3,6,0,698,702
76879,11,3,6,0,698,709
84274,12,2,6,0,698,710
92170,11,2,6,0,698,709
109919,9,2,6,0,698,707
111107,14,5,6,0,698,712
121849,2,2,6,0,698,700
126710,9,3,6,0,698,707
127350,11,2,6,0,698,709
129302,40,4,7,1,698,738
8609,10,2,6,0,699,709
23008,9,2,6,0,699,708
53657,9,2,6,0,699,708
55803,9,2,6,0,699,708
61536,10,1,6,0,699,709
63364,10,2,6,0,699,709
68010,10,1,6,0,699,709
68108,2,1,6,0,699,701
79675,8,2,6,0,699,707
88445,9,2,6,0,699,708
127469,12,1,6,1,699,711
7540,7,2,6,0,700,707
8595,7,2,6,0,700,707
12919,7,2,6,0,700,707
14177,7,2,6,0,700,707
16175,8,2,6,0,700,708
20163,7,2,6,0,700,707
20546,7,2,6,0,700,707
20699,7,2,6,0,700,707
22139,7,2,6,0,700,707
27323,7,2,6,0,700,707
29422,7,5,6,0,700,707
32086,7,2,6,0,700,707
32753,7,2,6,0,700,707
33943,7,2,6,0,700,707
37499,7,3,6,0,700,707
42168,7,2,6,0,700,707
42485,7,2,6,0,700,707
43342,7,2,6,0,700,707
44795,7,2,6,0,700,707
45638,7,2,6,0,700,707
45894,7,2,6,0,700,707
49856,7,2,6,0,700,707
52658,7,2,6,0,700,707
54356,7,2,6,0,700,707
54431,7,2,6,0,700,707
54650,7,2,6,0,700,707
57533,8,2,6,0,700,708
57732,7,5,6,0,700,707
58522,2,1,6,0,700,702
62277,7,2,6,0,700,707
62609,7,2,6,0,700,707
63483,7,2,6,0,700,707
65649,7,2,6,0,700,707
68146,7,2,6,0,700,707
68758,7,3,6,0,700,707
69803,7,2,6,0,700,707
71266,7,2,6,0,700,707
71285,7,2,6,0,700,707
73009,6,2,6,0,700,706
73142,7,2,6,0,700,707
73223,7,2,6,0,700,707
73622,7,2,6,0,700,707
74270,7,2,6,0,700,707
75483,27,2,7,1,700,727
77008,7,2,6,0,700,707
77642,7,2,6,0,700,707
80472,7,2,6,0,700,707
81474,7,2,6,0,700,707
87659,60,1,7,0,700,760
88010,7,2,6,0,700,707
90616,7,2,6,0,700,707
92253,7,5,6,0,700,707
92400,7,3,6,0,700,707
93712,7,2,6,0,700,707
95304,2,4,6,0,700,702
95658,7,2,6,0,700,707
97604,7,3,6,0,700,707
102648,27,2,7,1,700,727
105434,7,2,6,0,700,707
107697,7,2,6,0,700,707
108310,7,2,6,0,700,707
111399,7,2,6,0,700,707
111703,7,2,6,0,700,707
111830,7,2,6,0,700,707
113073,7,2,6,0,700,707
115155,7,2,6,0,700,707
121934,7,2,6,0,700,707
122282,7,2,6,0,700,707
126210,7,2,6,0,700,707
6686,5,2,6,0,701,706
9791,5,2,6,0,701,706
13575,6,2,6,0,701,707
14471,5,2,6,0,701,706
25463,5,2,6,0,701,706
25772,5,3,6,0,701,706
26749,6,2,6,0,701,707
26987,5,2,6,0,701,706
39560,5,4,6,0,701,706
47525,6,2,6,0,701,707
48761,9,4,6,0,701,710
49986,5,2,6,0,701,706
52519,5,2,6,0,701,706
62365,5,3,6,0,701,706
67744,5,2,6,0,701,706
68399,5,4,6,0,701,706
69743,5,3,6,0,701,706
85726,5,2,6,0,701,706
108808,6,1,6,0,701,707
111452,5,2,6,0,701,706
115141,5,3,6,0,701,706
115306,5,2,6,0,701,706
115347,5,2,6,0,701,706
121570,6,2,6,0,701,707
126620,5,2,6,0,701,706
23524,4,2,6,0,702,706
69322,4,3,6,0,702,706
79590,2,3,6,0,702,704
82733,4,2,6,0,702,706
91573,4,2,6,0,702,706
99216,2,3,6,0,702,704
105389,4,2,6,0,702,706
108820,4,2,6,0,702,706
116969,4,2,6,0,702,706
98575,7,3,6,0,703,710
23699,2,4,6,0,704,706
95304,3,5,6,0,704,707
47089,10,3,6,1,706,716
52520,4,4,6,0,706,710
71573,3,4,6,0,706,709
72409,16,1,6,1,706,722
103605,5,5,6,0,706,711
6980,3,7,6,0,707,710
14844,3,4,6,0,707,710
34273,3,5,6,0,707,710
49971,3,3,6,0,707,710
85756,3,3,6,0,707,710
91557,20,4,7,1,707,727
121222,4,2,6,1,707,711
121849,2,3,6,0,707,709
14555,159,2,9,0,708,867
64285,18,1,7,1,708,726
53188,2,4,6,0,710,712
105752,13,3,6,1,710,723
106408,14,1,6,1,710,724
123271,27,2,7,1,710,737
54037,12,1,6,1,711,723
70474,12,1,6,1,711,723
40939,6,1,6,1,714,720
16595,5,3,6,1,718,723
55899,5,4,6,1,718,723
21302,5,2,6,1,719,724
114048,8,2,7,1,719,727
13019,32,2,7,0,734,766
75483,53,3,7,1,734,787
9059,26,3,7,0,737,763
10731,69,4,8,0,737,806
16408,26,3,7,0,737,763
17915,26,3,7,0,737,763
35588,26,3,7,0,737,763
39448,6,4,7,0,737,743
39560,27,5,7,0,737,764
46760,26,5,7,0,737,763
52288,26,6,7,0,737,763
56860,26,3,7,0,737,763
62365,27,4,7,0,737,764
68180,26,5,7,0,737,763
69120,26,5,7,0,737,763
69322,27,4,7,0,737,764
69743,27,4,7,0,737,764
69997,26,3,7,0,737,763
76409,26,3,7,0,737,763
78603,26,5,7,0,737,763
79590,26,4,7,0,737,763
83147,26,5,7,0,737,763
86704,69,4,8,0,737,806
95304,26,6,7,0,737,763
99216,26,4,7,0,737,763
99984,28,5,7,0,737,765
101352,24,2,7,1,737,761
103605,27,6,7,0,737,764
112829,26,5,7,0,737,763
115141,28,4,7,0,737,765
121849,13,4,7,0,737,750
129748,26,3,7,0,737,763
126710,6,4,7,0,738,744
12687,11,3,7,0,739,750
16604,11,3,7,0,739,750
49738,11,4,7,0,739,750
111374,11,5,7,0,739,750
67360,11,1,7,0,741,752
83063,13,1,7,0,741,754
115490,12,1,7,0,741,753
65632,10,1,7,0,742,752
86137,10,2,7,0,742,752
106071,7,4,7,0,742,749
23188,9,1,7,0,743,752
27971,30,2,7,0,743,773
34100,7,2,7,0,743,750
48818,7,1,7,0,743,750
50752,9,1,7,0,743,752
56463,9,2,7,0,743,752
71903,9,1,7,0,743,752
83682,9,1,7,0,743,752
94744,9,2,7,0,743,752
106665,10,2,7,0,743,753
13287,7,2,7,0,744,751
37191,3,2,7,0,747,750
126710,15,5,7,0,749,764
78554,12,1,7,1,750,762
91426,14,1,7,0,750,764
92506,14,1,7,0,750,764
99968,25,1,7,0,750,775
126827,14,1,7,0,750,764
7909,13,2,7,0,751,764
16595,56,4,8,1,751,807
33102,59,1,8,1,751,810
123271,70,3,8,1,751,821
39448,11,5,7,0,752,763
59062,24,1,7,1,753,777
115971,11,1,7,0,753,764
74643,77,1,8,1,755,832
26891,31,1,7,0,756,787
39928,29,3,7,0,756,785
121222,12,3,7,0,756,768
25672,17,1,7,0,757,774
29334,29,1,7,0,757,786
58416,33,3,7,1,757,790
14311,27,1,7,0,758,785
19229,27,1,7,0,758,785
41256,27,2,7,0,758,785
46941,27,1,7,0,758,785
47767,27,1,7,0,758,785
54037,106,2,9,1,758,864
61470,27,1,7,0,758,785
73948,62,1,8,1,758,820
78488,35,1,7,1,758,793
100842,27,1,7,0,758,785
106665,26,3,7,0,758,784
124093,23,3,7,0,758,781
126599,27,1,7,0,758,785
23188,25,2,7,0,759,784
23932,26,1,7,0,759,785
37899,26,1,7,0,759,785
43347,27,2,7,0,759,786
45670,41,2,8,0,759,800
50752,25,2,7,0,759,784
60947,23,2,7,0,759,782
69330,13,3,7,0,759,772
88272,26,5,7,0,759,785
91782,26,1,7,0,759,785
106574,19,2,7,0,759,778
120315,27,3,7,0,759,786
122831,26,3,7,0,759,785
5596,25,1,7,0,760,785
13016,3,1,7,0,760,763
14380,44,1,8,0,760,804
18519,20,1,7,0,760,780
30561,20,1,7,0,760,780
34100,14,3,7,0,760,774
38707,27,1,7,0,760,787
45534,20,1,7,0,760,780
49971,4,4,7,0,760,764
64609,45,1,8,0,760,805
65901,20,1,7,0,760,780
71282,2,4,7,1,760,762
83063,32,2,7,0,760,792
95430,21,3,7,0,760,781
96405,24,1,7,0,760,784
114097,19,1,7,0,760,779
114687,24,1,7,0,760,784
125421,7,1,7,0,760,767
126156,20,1,7,0,760,780
5781,21,1,7,0,761,782
12009,21,1,7,0,761,782
13287,24,3,7,0,761,785
15859,21,1,7,0,761,782
23041,21,1,7,0,761,782
36867,21,1,7,0,761,782
38701,21,1,7,0,761,782
44068,22,1,7,0,761,783
65232,19,1,7,0,761,780
68758,18,4,7,0,761,779
68972,56,2,8,0,761,817
74573,19,1,7,0,761,780
94750,19,1,7,0,761,780
101466,17,1,7,0,761,778
117070,22,3,7,0,761,783
121920,17,3,7,0,761,778
122081,25,1,7,0,761,786
16197,20,2,7,0,762,782
21456,20,1,7,0,762,782
23400,20,2,7,0,762,782
44787,23,1,7,0,762,785
47606,20,1,7,0,762,782
49738,19,5,7,0,762,781
68731,20,1,7,0,762,782
70400,18,1,7,0,762,780
74586,20,2,7,0,762,782
84452,15,2,7,0,762,777
93089,70,1,8,0,762,832
93484,18,1,7,0,762,780
112345,20,1,7,0,762,782
115890,20,4,7,0,762,782
11016,17,2,7,0,763,780
17259,13,1,7,0,763,776
20163,17,3,7,0,763,780
23524,19,3,7,0,763,782
24044,13,1,7,0,763,776
27059,19,4,7,0,763,782
36819,15,1,7,1,763,778
37942,13,1,7,0,763,776
43520,13,1,7,0,763,776
51880,13,3,7,0,763,776
67949,19,2,7,0,763,782
68180,13,6,7,0,763,776
71285,13,3,7,0,763,776
71903,46,2,8,0,763,809
73053,2,2,7,0,763,765
82733,19,3,7,0,763,782
89860,15,1,7,1,763,778
95988,7,3,7,0,763,770
97036,21,2,7,0,763,784
103311,9,2,7,0,763,772
105389,19,3,7,0,763,782
106071,19,5,7,0,763,782
108820,19,3,7,0,763,782
123984,7,3,7,0,763,770
127233,4,1,7,0,763,767
6836,13,1,7,0,764,777
7909,7,3,7,0,764,771
9791,13,3,7,0,764,777
12725,13,1,7,0,764,777
13620,4,1,7,1,764,768
22135,13,1,7,0,764,777
22832,15,1,7,0,764,779
28991,18,2,7,0,764,782
37936,12,1,7,0,764,776
42130,5,2,7,0,764,769
44724,19,1,7,0,764,783
46757,13,1,7,0,764,777
49623,13,1,7,0,764,777
52288,6,7,7,0,764,770
52624,16,1,7,0,764,780
55237,12,2,7,0,764,776
55382,10,2,7,0,764,774
55907,13,1,7,0,764,777
58522,13,2,7,0,764,777
62040,18,2,7,0,764,782
63152,13,1,7,0,764,777
70144,15,1,7,0,764,779
74359,13,1,7,0,764,777
90264,18,2,7,0,764,782
95658,13,3,7,0,764,777
97186,12,1,7,0,764,776
102139,22,1,7,1,764,786
103881,7,2,7,0,764,771
104754,13,1,7,0,764,777
104831,22,1,7,0,764,786
107582,12,1,7,0,764,776
119421,13,1,7,0,764,777
128491,12,1,7,0,764,776
25345,17,1,7,0,765,782
30398,11,2,7,0,765,776
40482,17,2,7,0,765,782
48898,44,1,8,0,765,809
53034,17,1,7,0,765,782
57732,14,6,7,0,765,779
62785,11,1,7,0,765,776
65074,17,1,7,0,765,782
65803,11,1,7,0,765,776
90138,42,1,8,1,765,807
90574,16,2,7,0,765,781
124620,17,1,7,0,765,782
129302,41,5,8,0,765,806
9423,16,2,7,0,766,782
23395,18,1,7,0,766,784
25598,10,2,7,0,766,776
38084,10,2,7,0,766,776
48617,3,3,7,0,766,769
49884,14,1,7,0,766,780
54436,41,1,8,0,766,807
66631,15,1,7,0,766,781
70429,11,3,7,0,766,777
73427,26,1,7,0,766,792
91349,16,1,7,0,766,782
97432,16,1,7,0,766,782
102152,14,1,7,0,766,780
108761,30,1,7,0,766,796
124700,16,1,7,0,766,782
7444,10,3,7,0,767,777
12200,8,1,7,0,767,775
13587,9,3,7,0,767,776
13648,2,5,7,0,767,769
21302,7,3,7,1,767,774
31604,9,1,7,0,767,776
40740,8,1,7,0,767,775
46921,27,1,7,0,767,794
49542,9,1,7,0,767,776
73223,9,3,7,0,767,776
74721,39,1,8,0,767,806
76879,60,4,8,0,767,827
77642,9,3,7,0,767,776
106977,10,1,7,0,767,777
107528,13,1,7,0,767,780
111784,9,3,7,0,767,776
114048,8,3,7,0,767,775
118858,7,1,7,0,767,774
119583,9,1,7,0,767,776
122516,47,4,8,0,767,814
124404,9,1,7,0,767,776
5924,11,1,7,0,768,779
8027,8,1,7,0,768,776
14859,41,1,8,1,768,809
18335,3,3,7,0,768,771
24332,8,1,7,0,768,776
39870,12,1,7,1,768,780
59254,18,2,7,0,768,786
62511,38,1,8,0,768,806
88534,31,1,7,1,768,799
95662,8,1,7,0,768,776
117206,5,2,7,1,768,773
128052,5,1,7,1,768,773
21837,28,1,7,1,769,797
28125,56,1,8,1,769,825
59772,39,1,8,1,769,808
63669,13,1,7,0,769,782
93476,31,1,8,1,769,800
107513,2,1,7,1,769,771
111479,10,2,7,0,769,779
124767,42,1,8,1,769,811
88136,4,1,7,0,770,774
115777,12,1,7,0,770,782
122485,6,1,7,0,770,776
24491,29,1,8,1,771,800
69795,40,1,8,0,771,811
96962,30,1,8,1,771,801
115158,25,1,7,0,772,797
14503,18,1,7,0,773,791
46896,48,1,8,1,773,821
49317,26,1,7,1,773,799
51849,33,1,8,0,773,806
67360,19,2,7,0,773,792
99677,14,1,7,0,773,787
113766,33,1,8,0,773,806
114751,55,1,8,1,773,828
121222,19,4,7,1,773,792
13648,19,6,7,0,774,793
27642,14,1,7,0,774,788
36133,21,1,7,0,774,795
38483,14,1,7,0,774,788
58001,14,1,7,0,774,788
59451,9,2,7,0,774,783
127233,2,2,7,0,774,776
9721,2,2,7,0,775,777
41662,108,2,10,0,775,883
64394,11,2,7,0,775,786
78554,4,2,7,1,775,779
94392,31,1,8,0,775,806
120716,8,1,7,0,775,783
124869,31,1,8,1,775,806
127469,10,2,7,1,775,785
7923,19,1,7,0,776,795
13016,3,2,7,0,776,779
83682,7,2,7,0,776,783
9670,4,2,7,0,777,781
13019,6,3,7,0,777,783
13143,4,2,7,0,777,781
19856,29,1,8,0,777,806
41390,8,1,7,0,777,785
52049,29,1,8,0,777,806
58645,8,1,7,0,777,785
74083,18,1,7,1,777,795
90664,4,3,7,0,777,781
99984,11,6,7,0,777,788
101486,4,3,7,0,777,781
107449,8,3,7,0,777,785
110650,4,2,7,0,777,781
120832,4,2,7,0,777,781
122541,6,1,7,1,777,783
8595,33,3,8,0,778,811
49971,6,5,7,0,778,784
52216,37,1,8,1,778,815
64285,35,2,8,1,778,813
101466,2,2,7,0,778,780
12277,12,1,7,0,779,791
19442,6,1,7,0,779,785
46760,6,6,7,0,779,785
47089,18,4,7,1,779,797
60043,14,1,7,0,779,793
69120,6,6,7,0,779,785
71282,19,5,7,1,779,798
75738,4,1,7,0,779,783
77753,6,2,7,0,779,785
78603,6,6,7,0,779,785
84452,5,3,7,0,779,784
25025,4,1,7,0,780,784
44886,13,1,7,1,780,793
65632,14,2,7,0,780,794
67759,9,1,7,1,780,789
70474,32,2,8,1,780,812
73053,3,3,7,0,780,783
85183,30,1,8,1,780,810
86137,13,3,7,0,780,793
101352,9,3,7,1,780,789
106408,32,2,8,1,780,812
110418,2,2,7,0,780,782
37763,18,2,7,0,781,799
39448,10,6,7,0,781,791
94744,9,3,7,0,781,790
66649,15,1,7,0,782,797
77628,28,2,8,1,782,810
96686,7,1,7,0,782,789
23277,6,1,7,1,783,789
24137,20,1,8,1,783,803
35977,21,1,8,1,783,804
55382,28,3,8,0,783,811
115490,38,2,8,0,783,821
16519,6,1,7,0,784,790
34100,6,4,7,0,784,790
43491,6,1,7,0,784,790
52613,35,2,8,1,784,819
54851,25,1,8,1,784,809
60651,4,4,7,1,784,788
73222,42,1,8,1,784,826
91889,6,1,7,0,784,790
41488,24,1,8,1,785,809
91048,4,1,7,0,785,789
21015,4,1,7,0,786,790
37936,8,2,7,0,786,794
124093,23,4,8,0,787,810
24332,17,2,8,0,789,806
57186,14,1,8,1,789,803
51672,11,1,8,1,790,801
55899,8,5,7,1,790,798
24609,20,1,8,0,791,811
7444,14,4,8,0,792,806
9423,25,3,8,0,792,817
28532,37,1,8,1,792,829
68180,22,7,8,0,792,814
95430,9,4,8,0,792,801
99984,24,7,8,0,792,816
101466,2,3,7,0,792,794
110418,17,3,8,0,792,809
112829,22,6,8,0,792,814
114309,6,1,7,0,792,798
46760,21,7,8,0,793,814
54709,13,1,8,0,793,806
59062,8,2,8,1,793,801
69120,21,7,8,0,793,814
78603,21,7,8,0,793,814
89023,30,5,8,0,793,823
92993,34,1,8,1,793,827
111479,4,3,7,0,793,797
114218,20,1,8,1,793,813
115777,33,2,8,0,793,826
12687,12,4,8,0,794,806
16604,12,4,8,0,794,806
31957,12,1,8,0,794,806
32191,39,4,8,0,794,833
42149,39,3,8,0,794,833
49196,39,1,8,0,794,833
49738,8,6,8,0,794,802
50043,39,1,8,0,794,833
50381,39,1,8,0,794,833
63483,55,3,9,0,794,849
65803,12,2,8,0,794,806
74573,15,2,8,0,794,809
78554,64,3,9,1,794,858
79959,23,1,8,0,794,817
90664,15,4,8,0,794,809
94750,15,2,8,0,794,809
99968,67,2,9,0,794,861
107341,39,1,8,0,794,833
111374,12,6,8,0,794,806
121484,25,1,8,0,794,819
9723,11,3,8,0,795,806
22135,12,2,8,0,795,807
46757,12,2,8,0,795,807
52414,9,1,8,0,795,804
58522,12,3,8,0,795,807
94346,21,2,8,0,795,816
95658,12,4,8,0,795,807
120315,10,4,8,0,795,805
121849,33,5,8,0,795,828
5924,11,2,8,0,796,807
6836,11,2,8,0,796,807
9791,11,4,8,0,796,807
12725,11,2,8,0,796,807
26145,15,1,8,0,796,811
49623,11,2,8,0,796,807
55907,11,2,8,0,796,807
57732,8,7,8,0,796,804
59918,74,1,9,0,796,870
75691,74,1,9,0,796,870
75738,13,2,8,0,796,809
78623,21,1,8,0,796,817
79675,10,3,8,0,796,806
88921,74,1,9,0,796,870
97036,10,3,8,0,796,806
99620,74,1,9,0,796,870
115633,34,2,8,0,796,830
119421,11,2,8,0,796,807
6753,14,1,8,0,797,811
9460,18,6,8,0,797,815
17223,30,1,8,1,797,827
21302,4,4,8,1,797,801
27716,13,1,8,0,797,810
41511,25,1,8,0,797,822
55315,22,4,8,0,797,819
59394,9,1,8,0,797,806
66631,19,2,8,0,797,816
81354,14,1,8,0,797,811
86793,14,1,8,0,797,811
88445,20,3,8,0,797,817
111107,18,6,8,0,797,815
112459,20,3,8,0,797,817
114048,30,4,8,1,797,827
117460,15,1,8,0,797,812
118539,20,1,8,0,797,817
13587,8,4,8,0,798,806
16057,8,2,8,0,798,806
41808,19,4,8,0,798,817
47669,8,1,8,0,798,806
58416,31,4,8,1,798,829
59028,13,1,8,0,798,811
98175,19,5,8,0,798,817
106071,7,6,8,0,798,805
44724,7,2,8,0,799,806
102152,5,2,8,0,799,804
124620,7,2,8,0,799,806
13019,18,4,8,0,801,819
90574,3,3,8,0,801,804
96490,15,3,8,0,801,816
110456,15,3,8,0,801,816
13620,4,2,8,1,802,806
37750,35,1,8,0,803,838
37766,35,1,8,0,803,838
37936,9,3,8,0,803,812
102562,82,1,10,0,803,885
124779,15,1,8,0,803,818
128052,27,2,8,1,803,830
49738,2,7,8,0,804,806
22595,32,1,8,0,805,837
85508,69,1,9,0,805,874
7359,52,3,9,0,806,858
9944,29,1,8,0,806,835
10316,33,3,8,1,806,839
11043,29,3,8,0,806,835
16228,29,1,8,0,806,835
18782,8,1,8,0,806,814
24570,29,1,8,0,806,835
37860,29,1,8,0,806,835
53253,8,1,8,0,806,814
56041,29,1,8,0,806,835
70400,9,2,8,0,806,815
83768,29,1,8,0,806,835
86699,8,1,8,0,806,814
86992,29,1,8,0,806,835
89814,29,1,8,0,806,835
92291,29,1,8,0,806,835
100601,29,1,8,0,806,835
102628,47,3,9,1,806,853
103904,9,1,8,0,806,815
107645,29,1,8,0,806,835
107770,29,1,8,0,806,835
112679,29,1,8,0,806,835
121394,8,1,8,0,806,814
7909,10,4,8,0,807,817
52288,10,8,8,0,807,817
56860,6,4,8,0,807,813
69322,10,5,8,0,807,817
69997,6,4,8,0,807,813
87403,36,2,9,1,807,843
110992,10,1,8,0,807,817
115971,51,2,9,0,807,858
122713,8,1,8,0,807,815
7725,63,1,9,0,808,871
11236,63,1,9,0,808,871
13348,63,1,9,0,808,871
16197,63,3,9,0,808,871
16260,63,1,9,0,808,871
24231,63,1,9,0,808,871
29711,63,1,9,0,808,871
37716,63,1,9,0,808,871
39923,63,1,9,0,808,871
49126,63,1,9,0,808,871
63228,63,1,9,0,808,871
87377,63,1,9,0,808,871
90138,18,2,8,1,808,826
94840,63,1,9,0,808,871
95075,13,1,8,0,808,821
5596,11,2,8,0,809,820
9059,3,4,8,0,809,812
17420,29,2,8,0,809,838
21570,14,3,8,0,809,823
67759,20,2,8,1,809,829
101466,40,4,9,0,809,849
48021,6,1,8,0,810,816
67949,8,3,8,0,810,818
68507,5,1,8,1,811,816
7463,25,1,8,0,812,837
104831,22,2,8,0,812,834
105955,22,1,8,0,812,834
115060,21,2,8,1,812,833
18402,64,1,9,0,813,877
65337,64,1,9,0,813,877
107528,7,2,8,0,813,820
112345,21,2,8,0,813,834
113318,64,1,9,0,813,877
113912,25,2,8,0,813,838
23188,4,3,8,0,814,818
34100,4,5,8,0,814,818
50752,4,3,8,0,814,818
55382,17,4,8,0,814,831
78064,4,1,8,0,814,818
83393,17,2,8,0,814,831
83682,4,3,8,0,814,818
96215,79,1,10,1,814,893
106665,4,4,8,0,814,818
41843,19,1,8,0,815,834
44233,22,1,8,0,815,837
46921,12,2,8,1,815,827
60665,3,1,8,0,815,818
63277,19,1,8,0,815,834
81354,6,2,8,0,815,821
101352,79,4,10,1,815,894
30817,21,2,8,0,816,837
47089,7,5,8,1,816,823
53188,14,5,8,0,816,830
60651,16,5,8,1,816,832
8111,60,1,9,0,817,877
54436,16,2,8,0,817,833
10731,9,5,8,0,818,827
32165,9,4,8,0,818,827
49986,16,3,8,0,818,834
50598,16,1,8,0,818,834
60800,16,1,8,0,818,834
62918,9,5,8,0,818,827
70172,54,1,9,1,818,872
76152,12,2,8,1,818,830
80788,8,2,8,0,818,826
84686,19,1,8,0,818,837
86704,9,5,8,0,818,827
67949,15,4,8,0,819,834
27101,14,1,8,0,820,834
75483,24,4,9,1,820,844
100744,85,1,10,1,822,907
20898,11,1,8,0,823,834
60665,11,2,8,0,823,834
65232,11,2,8,0,823,834
101538,15,1,8,0,823,838
111781,11,1,8,0,823,834
120281,15,1,8,0,823,838
45315,14,1,8,0,824,838
48021,14,2,8,0,824,838
124779,14,2,8,0,824,838
23957,39,1,9,0,825,864
32348,3,1,8,0,825,828
43462,12,3,8,0,825,837
53253,12,2,8,0,825,837
78064,4,2,8,0,825,829
86699,12,2,8,0,825,837
87150,10,1,8,0,825,835
107528,9,3,8,0,825,834
6980,10,8,8,0,826,836
13280,8,1,8,0,826,834
40939,35,2,9,1,826,861
41252,9,1,8,0,826,835
41794,10,1,8,0,826,836
82815,10,1,8,0,826,836
21302,3,5,8,1,827,830
73270,34,1,9,0,827,861
127469,11,3,8,1,827,838
8252,34,1,9,0,828,862
24754,34,1,9,0,828,862
39712,34,1,9,0,828,862
44018,33,1,9,0,828,861
51264,6,1,8,0,828,834
68155,6,4,8,0,828,834
81348,6,1,8,0,828,834
86224,12,1,9,0,828,840
100108,6,1,8,0,828,834
121222,12,5,9,0,828,840
122713,50,2,9,0,828,878
32972,8,1,8,0,829,837
39959,4,1,8,0,829,833
93712,4,3,8,0,829,833
115777,7,3,8,0,829,836
120716,8,2,8,0,829,837
35085,2,1,8,0,830,832
95791,8,1,8,0,830,838
124714,2,1,8,0,830,832
53092,37,1,9,0,831,868
110289,46,1,9,0,831,877
90138,9,3,9,1,832,841
120751,15,3,9,1,832,847
7909,2,5,8,0,833,835
14565,37,1,9,0,833,870
67257,37,1,9,0,833,870
71225,37,1,9,0,833,870
71282,22,6,9,1,833,855
78064,29,3,9,0,833,862
121849,3,6,8,0,833,836
9460,3,7,8,0,834,837
74083,34,2,9,1,834,868
80788,2,3,8,0,834,836
115141,50,5,10,0,834,884
16408,14,4,9,0,835,849
17915,14,4,9,0,835,849
35588,14,4,9,0,835,849
35977,6,2,9,1,835,841
39448,14,7,9,0,835,849
52288,19,9,9,0,835,854
57044,14,3,9,0,835,849
67759,2,3,8,1,835,837
69322,21,6,9,0,835,856
76409,14,4,9,0,835,849
79590,14,5,9,0,835,849
83147,14,6,9,0,835,849
95304,14,7,9,0,835,849
99216,14,5,9,0,835,849
99984,14,8,9,0,835,849
103904,2,2,8,0,835,837
106589,40,1,9,1,835,875
109919,43,3,9,0,835,878
110992,21,2,9,0,835,856
126710,30,6,9,0,835,865
129748,14,4,9,0,835,849
9059,13,5,9,0,836,849
46760,13,8,9,0,836,849
69120,13,8,9,0,836,849
78603,13,8,9,0,836,849
127539,45,1,10,1,836,881
23277,15,2,9,1,838,853
82034,27,1,9,0,839,866
13019,9,5,9,0,840,849
52158,3,1,9,1,840,843
74643,72,2,10,1,840,912
28532,41,2,10,1,841,882
12645,38,1,10,1,842,880
55899,5,6,9,1,842,847
28125,30,2,9,1,843,873
37188,30,1,9,1,843,873
58416,68,5,10,1,843,911
123271,66,4,10,1,843,909
73948,64,2,10,1,844,908
92993,32,2,9,1,844,876
102139,14,2,9,1,844,858
36819,72,2,10,1,845,917
41452,26,1,9,1,845,871
52216,26,2,9,1,845,871
78741,28,1,9,1,845,873
89860,72,2,10,1,845,917
114218,36,2,10,1,845,881
26423,60,1,10,1,846,906
45670,13,3,9,0,846,859
86586,24,1,9,1,846,870
95093,10,1,9,1,846,856
18561,15,1,9,0,847,862
48021,9,3,9,0,847,856
52613,22,3,9,1,847,869
61470,18,2,9,0,847,865
64285,41,3,10,1,847,888
125421,16,2,9,0,847,863
126599,18,2,9,0,847,865
5596,11,3,9,0,848,859
21639,20,1,9,1,848,868
23188,7,4,9,0,848,855
33827,6,4,9,1,848,854
34100,13,6,9,0,848,861
41256,11,3,9,0,848,859
50752,7,4,9,0,848,855
83682,51,4,10,0,848,899
96467,20,2,9,1,848,868
106408,39,3,10,1,848,887
106665,7,5,9,0,848,855
51429,40,1,10,1,849,889
59831,7,1,9,0,849,856
63837,37,1,10,1,849,886
70474,37,3,10,1,849,886
78488,18,2,9,1,849,867
80788,6,4,9,0,849,855
96962,43,2,10,1,849,892
103246,7,1,9,0,849,856
121849,14,7,9,0,849,863
122516,19,5,9,0,849,868
26288,16,1,9,1,850,866
45089,16,1,9,1,850,866
45315,26,2,9,0,850,876
46896,16,2,9,1,850,866
55382,40,5,10,0,850,890
55899,2,7,9,1,850,852
70770,16,1,9,1,850,866
74189,16,1,9,1,850,866
85183,16,2,9,1,850,866
99525,16,1,9,1,850,866
104612,16,2,9,1,850,866
112345,12,3,9,0,850,862
114309,24,2,9,0,850,874
124779,25,3,9,0,850,875
128816,16,1,9,1,850,866
10554,23,1,9,0,851,874
12918,10,1,9,0,851,861
26315,33,1,10,1,851,884
65232,8,3,9,0,851,859
73789,16,3,9,0,851,867
80787,42,1,10,0,851,893
93089,38,2,10,0,851,889
95127,36,1,10,1,851,887
100579,23,1,9,0,851,874
122541,4,2,9,1,851,855
127704,5,1,9,1,851,856
21302,6,6,9,1,852,858
55727,12,1,9,1,852,864
59962,3,2,9,1,852,855
97865,36,1,10,0,852,888
98405,26,3,9,1,852,878
107528,44,4,10,0,852,896
114480,12,1,9,1,852,864
117206,31,3,10,1,852,883
128052,31,3,10,1,852,883
10316,35,4,10,1,853,888
10940,51,1,10,1,853,904
33184,10,1,9,1,853,863
48617,13,4,9,0,853,866
90138,5,4,9,1,853,858
116454,24,1,9,0,853,877
24137,26,2,10,1,854,880
37750,28,2,10,0,854,882
37766,28,2,10,0,854,882
49724,8,1,9,1,854,862
50117,19,1,9,0,854,873
62511,30,2,10,0,854,884
68155,24,5,9,0,854,878
83393,26,3,10,0,854,880
94392,24,2,9,0,854,878
100108,24,2,9,0,854,878
110296,8,3,9,0,854,862
111107,30,7,10,0,854,884
121288,11,3,9,0,854,865
122485,35,2,10,0,854,889
125200,26,1,10,1,854,880
9460,11,8,9,0,855,866
39959,23,2,9,0,855,878
47089,10,6,9,1,855,865
62080,15,1,9,0,855,870
63889,6,1,9,1,855,861
75483,44,5,10,1,855,899
91961,6,1,9,1,855,861
102865,15,1,9,0,855,870
35977,19,3,9,1,856,875
42725,23,1,9,1,856,879
52288,4,10,9,0,856,860
63669,40,2,10,0,856,896
75191,13,1,9,0,856,869
94865,13,1,9,0,856,869
104160,3,1,9,1,856,859
105107,24,1,10,1,856,880
106832,23,1,9,1,856,879
118051,23,1,9,1,856,879
18118,4,1,9,0,857,861
24491,30,2,10,1,857,887
36368,2,1,9,1,857,859
39870,3,2,9,1,857,860
103289,8,1,9,0,857,865
103882,22,1,9,1,857,879
106418,13,1,9,0,857,870
106808,2,1,9,1,857,859
128212,38,1,10,1,857,895
129302,2,6,9,1,857,859
13068,41,1,10,1,858,899
29479,28,1,10,0,858,886
30865,42,1,10,0,858,900
32650,28,1,10,0,858,886
41703,41,1,10,1,858,899
51495,28,1,10,0,858,886
51672,19,2,9,1,858,877
55803,10,3,9,1,858,868
57568,20,4,9,0,858,878
60428,9,1,9,0,858,867
64889,28,1,10,0,858,886
65214,28,1,10,0,858,886
78554,24,4,10,1,858,882
79119,9,1,9,0,858,867
95384,28,1,10,0,858,886
95775,28,1,10,0,858,886
96686,41,2,10,0,858,899
96749,28,1,10,0,858,886
110012,28,1,10,0,858,886
110018,20,1,9,0,858,878
111854,9,1,9,0,858,867
129056,9,1,9,0,858,867
7463,22,2,10,0,859,881
16068,9,1,9,0,859,868
21302,3,7,9,1,859,862
69666,5,1,9,1,859,864
82627,9,1,9,0,859,868
86059,61,1,11,1,859,920
10500,24,1,10,0,860,884
12369,11,3,9,0,860,871
13019,27,6,10,0,860,887
18253,11,1,9,0,860,871
21571,11,1,9,0,860,871
24609,21,2,10,0,860,881
28434,11,1,9,0,860,871
34273,2,6,9,0,860,862
39448,3,8,9,0,860,863
43491,22,2,10,0,860,882
44341,11,1,9,0,860,871
47237,11,1,9,0,860,871
50405,11,1,9,0,860,871
51125,11,1,9,0,860,871
51801,24,1,10,0,860,884
52747,23,3,10,0,860,883
53117,11,1,9,0,860,871
58494,11,1,9,0,860,871
59588,11,1,9,0,860,871
60163,11,1,9,0,860,871
61827,11,1,9,0,860,871
64202,11,1,9,0,860,871
65167,11,1,9,0,860,871
72358,11,1,9,0,860,871
79703,11,1,9,0,860,871
82281,11,1,9,0,860,871
84743,11,1,9,0,860,871
91889,22,2,10,0,860,882
94087,11,1,9,0,860,871
99485,11,1,9,0,860,871
103881,7,3,9,0,860,867
104831,36,3,10,0,860,896
105540,5,1,9,0,860,865
111479,23,4,10,0,860,883
127506,11,1,9,0,860,871
9791,4,5,9,0,861,865
31655,21,2,10,0,861,882
43462,20,4,10,0,861,881
46606,35,1,10,0,861,896
46921,14,3,9,1,861,875
62304,5,1,9,0,861,866
83063,27,3,10,0,861,888
87004,21,1,10,0,861,882
90313,35,1,10,0,861,896
92424,21,1,10,0,861,882
115024,14,1,9,0,861,875
126855,21,1,10,0,861,882
13746,19,1,10,0,862,881
22595,19,2,10,0,862,881
22760,19,1,10,0,862,881
23202,31,2,10,1,862,893
28319,10,1,9,0,862,872
30817,19,3,10,0,862,881
32348,19,2,10,0,862,881
37936,3,4,9,0,862,865
44724,21,3,10,0,862,883
44886,12,2,9,1,862,874
51653,34,1,10,0,862,896
53341,16,2,9,0,862,878
58338,19,3,10,0,862,881
65196,19,2,10,0,862,881
69322,19,7,10,0,862,881
73427,3,2,9,0,862,865
81348,16,2,9,0,862,878
86143,19,1,10,0,862,881
89023,12,6,9,0,862,874
90877,12,1,9,1,862,874
91349,21,2,10,0,862,883
95869,3,3,9,0,862,865
97055,10,1,9,0,862,872
97432,21,2,10,0,862,883
98575,19,4,10,0,862,881
99677,11,2,9,0,862,873
115260,27,1,10,0,862,889
119609,18,1,10,0,862,880
120281,12,2,9,1,862,874
123870,5,1,9,0,862,867
124700,21,2,10,0,862,883
125846,19,3,10,0,862,881
6753,18,2,10,0,863,881
6838,15,2,9,0,863,878
8595,17,4,10,0,863,880
9059,21,6,10,0,863,884
10731,21,6,10,0,863,884
12687,15,5,9,0,863,878
13280,15,2,9,0,863,878
13638,18,1,10,0,863,881
16408,18,5,10,0,863,881
16604,15,5,9,0,863,878
17385,18,1,10,0,863,881
17915,18,5,10,0,863,881
25153,9,1,9,0,863,872
26145,18,2,10,0,863,881
29422,15,6,9,0,863,878
31604,2,2,9,0,863,865
35588,18,5,10,0,863,881
36813,18,1,10,0,863,881
39560,21,6,10,0,863,884
40838,19,1,10,0,863,882
41843,15,2,9,0,863,878
46760,18,9,10,0,863,881
49738,15,8,9,0,863,878
52158,37,2,10,1,863,900
52520,8,5,9,0,863,871
54099,8,1,9,1,863,871
54709,18,2,10,0,863,881
56860,21,5,10,0,863,884
57044,15,4,9,0,863,878
59028,18,2,10,0,863,881
61536,15,2,9,0,863,878
62365,2,5,9,0,863,865
63277,15,2,9,0,863,878
65131,18,1,10,0,863,881
68180,18,8,10,0,863,881
69120,18,9,10,0,863,881
69743,21,5,10,0,863,884
69997,21,5,10,0,863,884
70126,18,1,10,0,863,881
73369,17,1,10,0,863,880
76409,18,5,10,0,863,881
76879,17,5,10,0,863,880
78603,18,9,10,0,863,881
79590,17,6,10,0,863,880
83147,18,7,10,0,863,881
86704,21,6,10,0,863,884
86793,18,2,10,0,863,881
94162,18,1,10,0,863,881
95304,2,8,9,0,863,865
99216,17,6,10,0,863,880
99261,18,1,10,0,863,881
99984,18,9,10,0,863,881
103605,21,7,10,0,863,884
103869,18,1,10,0,863,881
111374,15,7,9,0,863,878
112829,18,7,10,0,863,881
115633,15,3,9,0,863,878
123045,17,1,10,0,863,880
123506,18,1,10,0,863,881
129748,18,5,10,0,863,881
36823,17,3,10,0,864,881
43020,7,1,9,0,864,871
51264,14,2,9,0,864,878
70231,13,1,9,0,864,877
73053,25,4,10,0,864,889
84274,17,3,10,0,864,881
102338,7,1,9,0,864,871
107760,16,1,10,0,864,880
5546,13,1,9,0,865,878
6686,13,3,9,0,865,878
11736,16,3,10,0,865,881
13347,13,2,9,0,865,878
14471,13,3,9,0,865,878
18015,13,2,9,0,865,878
20898,13,2,9,0,865,878
21753,9,1,9,1,865,874
22135,13,3,9,0,865,878
24585,13,1,9,0,865,878
25463,13,3,9,0,865,878
26749,14,3,9,0,865,879
32191,13,5,9,0,865,878
33930,13,1,9,0,865,878
36167,14,1,9,0,865,879
37824,13,1,9,0,865,878
39234,13,1,9,0,865,878
39453,13,1,9,0,865,878
39652,14,1,9,0,865,879
40886,15,1,10,0,865,880
41198,13,1,9,0,865,878
42149,13,4,9,0,865,878
43109,13,1,9,0,865,878
47525,14,3,9,0,865,879
49196,13,2,9,0,865,878
50043,13,2,9,0,865,878
50381,13,2,9,0,865,878
50598,13,2,9,0,865,878
52519,13,3,9,0,865,878
52561,7,1,9,0,865,872
54081,13,1,9,0,865,878
55237,13,3,9,0,865,878
61440,13,1,9,0,865,878
67744,15,3,10,0,865,880
67949,13,5,9,0,865,878
68108,3,2,9,0,865,868
68399,13,5,9,0,865,878
69204,13,1,9,0,865,878
70429,13,4,9,0,865,878
71328,13,1,9,0,865,878
72148,13,1,9,0,865,878
73142,14,3,9,0,865,879
77642,13,4,9,0,865,878
80130,12,1,9,0,865,877
80788,13,5,9,0,865,878
84840,13,1,9,0,865,878
86400,6,1,9,0,865,871
88445,3,4,9,0,865,868
90292,11,1,9,0,865,876
91573,13,3,9,0,865,878
95494,13,1,9,0,865,878
95662,9,2,9,0,865,874
95791,13,2,9,0,865,878
99332,13,1,9,0,865,878
106265,13,1,9,0,865,878
107341,13,2,9,0,865,878
108310,13,3,9,0,865,878
108808,13,2,9,0,865,878
111452,15,3,10,0,865,880
112459,10,4,9,0,865,875
115777,16,4,10,0,865,881
116729,13,1,9,0,865,878
116969,13,3,9,0,865,878
118539,10,2,9,0,865,875
118716,16,1,10,0,865,881
118805,17,3,10,0,865,882
121570,13,3,9,0,865,878
122434,13,1,9,0,865,878
125887,13,1,9,0,865,878
128443,13,1,9,0,865,878
16175,13,3,9,0,866,879
17981,12,1,9,0,866,878
28318,3,1,9,0,866,869
44233,15,2,10,0,866,881
46757,13,3,9,0,866,879
53253,15,3,10,0,866,881
57533,13,3,9,0,866,879
86699,15,3,10,0,866,881
92869,12,1,9,0,866,878
103311,33,3,10,0,866,899
105955,4,2,9,0,866,870
114751,27,2,10,1,866,893
9944,12,2,9,0,867,879
11043,12,4,9,0,867,879
16228,12,2,9,0,867,879
24570,12,2,9,0,867,879
37860,12,2,9,0,867,879
56041,12,2,9,0,867,879
70129,16,1,10,0,867,883
71573,8,5,9,0,867,875
83768,12,2,9,0,867,879
86992,12,2,9,0,867,879
89814,12,2,9,0,867,879
92291,12,2,9,0,867,879
95345,11,2,9,0,867,878
100601,12,2,9,0,867,879
107645,12,2,9,0,867,879
107770,12,2,9,0,867,879
112679,12,2,9,0,867,879
23008,11,3,9,0,868,879
25772,10,4,9,0,868,878
38404,11,3,9,0,868,879
53188,15,6,10,0,868,883
53657,11,3,9,0,868,879
73454,13,3,10,0,868,881
86766,13,3,10,0,868,881
90596,12,1,10,0,868,880
24797,11,3,10,0,869,880
85756,12,4,10,0,869,881
108159,35,2,10,1,869,904
127350,13,3,10,0,869,882
129069,12,3,10,0,869,881
13728,9,2,9,0,870,879
18075,10,1,10,0,870,880
44621,11,1,10,0,870,881
60800,8,2,9,0,870,878
69666,7,2,9,1,870,877
26987,7,3,9,0,871,878
34273,5,7,9,0,871,876
49986,7,4,9,0,871,878
63483,7,4,9,0,871,878
93712,7,4,9,0,871,878
115347,7,3,9,0,871,878
127469,20,4,10,1,871,891
8609,5,3,9,0,872,877
13418,6,1,9,0,872,878
63041,7,1,9,0,872,879
79675,16,4,10,0,872,888
81474,6,3,9,0,872,878
7261,4,5,9,0,873,877
12784,4,1,9,0,873,877
14949,5,3,9,0,873,878
28426,4,3,9,0,873,877
32165,4,5,9,0,873,877
62918,4,6,9,0,873,877
92302,4,5,9,0,873,877
118053,4,2,9,0,873,877
118631,4,1,9,0,873,877
125749,3,1,9,1,873,876
25646,20,1,10,1,874,894
40073,2,1,9,1,874,876
49884,8,2,10,0,874,882
50752,12,5,10,0,874,886
59254,12,3,10,0,874,886
127704,6,2,10,1,874,880
21753,23,2,10,1,875,898
23188,11,5,10,0,875,886
71573,3,6,9,0,875,878
88445,4,5,9,0,875,879
124767,21,2,10,1,875,896
12369,7,4,10,0,876,883
18253,7,2,10,0,876,883
21571,7,2,10,0,876,883
28434,7,2,10,0,876,883
35977,28,4,10,1,876,904
44341,7,2,10,0,876,883
47237,7,2,10,0,876,883
50405,7,2,10,0,876,883
51125,7,2,10,0,876,883
53117,7,2,10,0,876,883
58494,7,2,10,0,876,883
59588,7,2,10,0,876,883
60163,7,2,10,0,876,883
61827,7,2,10,0,876,883
64202,7,2,10,0,876,883
65167,7,2,10,0,876,883
72358,7,2,10,0,876,883
79703,7,2,10,0,876,883
82281,7,2,10,0,876,883
84743,7,2,10,0,876,883
85183,24,3,10,1,876,900
94087,7,2,10,0,876,883
95093,12,2,10,1,876,888
99485,7,2,10,0,876,883
105540,23,2,10,0,876,899
127506,7,2,10,0,876,883
14555,2,3,9,0,877,879
46921,8,4,10,1,877,885
104160,2,2,9,1,877,879
109175,2,2,9,0,877,879
125421,16,3,10,0,877,893
9791,18,6,10,0,878,896
31604,18,3,10,0,878,896
52520,3,6,10,0,878,881
54436,3,3,10,0,878,881
61470,14,3,10,0,878,892
62365,6,6,10,0,878,884
66298,15,1,10,1,878,893
95304,2,9,10,0,878,880
96405,14,2,10,0,878,892
99968,6,3,10,0,878,884
101466,3,5,10,0,878,881
126599,14,3,10,0,878,892
27971,8,3,10,0,879,887
40939,18,3,10,1,879,897
42562,2,1,10,0,879,881
55803,20,4,10,1,879,899
71685,11,1,10,0,879,890
103904,2,3,10,0,879,881
124620,10,3,10,0,879,889
5596,9,4,10,0,880,889
7444,3,5,10,0,880,883
106095,9,1,10,0,880,889
115971,6,3,10,0,880,886
128816,14,2,10,1,880,894
9460,7,9,10,0,881,888
13287,4,4,10,0,881,885
18118,9,2,10,0,881,890
34273,2,8,10,0,881,883
39448,3,9,10,0,881,884
41256,4,4,10,0,881,885
78064,2,4,10,0,881,883
106665,4,6,10,0,881,885
110992,3,3,10,0,881,884
115060,4,3,10,1,881,885
76152,4,3,10,1,883,887
88534,5,2,10,1,883,888
78554,12,5,10,1,884,896
84728,15,1,10,1,884,899
106369,18,1,10,0,884,902
7909,13,6,10,0,886,899
48722,4,1,10,0,887,891
74189,12,2,10,1,887,899
32348,10,3,10,0,888,898
40838,8,2,10,0,888,896
43491,7,3,10,0,889,896
82627,11,2,10,0,889,900
91889,7,3,10,0,889,896
36813,5,2,10,0,890,895
65131,5,2,10,0,890,895
70126,5,2,10,0,890,895
94162,5,2,10,0,890,895
101466,5,6,10,0,890,895
103869,5,2,10,0,890,895
105752,5,4,10,0,890,895
123506,5,2,10,0,890,895
114218,8,3,10,1,891,899
126710,3,7,10,0,891,894
128052,24,4,10,1,891,915
55899,6,8,10,1,893,899
16595,5,5,10,1,894,899
46921,4,5,10,1,895,899
90138,8,5,10,1,896,904
39870,13,3,10,1,899,912
102628,3,4,10,1,899,902
122541,7,3,10,1,899,906
81383,2,1,10,1,901,903
98405,43,4,11,1,909,952
21837,13,2,11,1,914,927
35977,25,5,11,1,914,939
85301,15,1,11,0,914,929
94833,14,1,11,0,915,929
18503,12,1,11,0,916,928
24491,13,3,11,0,916,929
24954,13,1,11,0,916,929
47606,3,2,10,0,916,919
51580,18,1,11,0,916,934
60178,13,1,11,0,916,929
64720,2,1,10,0,916,918
78554,12,6,11,1,916,928
80788,4,6,11,0,916,920
82627,21,3,11,0,916,937
90596,20,2,11,0,916,936
95658,20,5,11,0,916,936
103731,15,1,11,0,916,931
104992,10,1,11,0,916,926
105540,13,3,11,0,916,929
14045,9,1,11,0,917,926
14606,10,1,11,0,917,927
21778,10,1,11,0,917,927
45162,20,1,11,0,917,937
49638,25,2,11,1,917,942
53621,10,1,11,0,917,927
67511,9,1,11,0,917,926
94347,10,1,11,0,917,927
119830,9,1,11,0,917,926
122531,9,1,11,0,917,926
11757,9,1,11,0,918,927
20699,9,3,11,0,918,927
21796,9,1,11,0,918,927
23228,10,1,11,0,918,928
28318,9,2,11,0,918,927
29385,10,1,11,0,918,928
31604,9,4,11,0,918,927
32092,10,1,11,0,918,928
33029,8,1,11,0,918,926
36164,9,1,11,0,918,927
37400,9,1,11,0,918,927
38180,10,1,11,0,918,928
38350,9,1,11,0,918,927
38404,9,4,11,0,918,927
44896,8,1,11,0,918,926
47054,10,2,11,0,918,928
59749,9,1,11,0,918,927
63078,9,1,11,0,918,927
63560,9,1,11,0,918,927
66631,9,3,11,0,918,927
68254,8,1,11,0,918,926
69722,8,2,11,0,918,926
70087,9,1,11,0,918,927
81381,10,1,11,0,918,928
87166,9,1,11,0,918,927
88423,9,1,11,0,918,927
90642,10,2,11,0,918,928
91113,9,1,11,0,918,927
94593,9,1,11,0,918,927
94854,9,1,11,0,918,927
104327,9,1,11,0,918,927
104976,9,1,11,0,918,927
106381,10,1,11,0,918,928
107894,9,1,11,0,918,927
108398,9,1,11,0,918,927
108603,9,1,11,0,918,927
108808,9,3,11,0,918,927
112459,10,5,11,0,918,928
114811,10,1,11,0,918,928
115496,9,1,11,0,918,927
116996,9,1,11,0,918,927
118551,9,2,11,0,918,927
118637,9,3,11,0,918,927
120187,9,1,11,0,918,927
125049,9,1,11,0,918,927
127526,10,2,11,0,918,928
25153,7,2,11,0,919,926
57780,8,1,11,0,919,927
74270,7,3,11,0,919,926
88411,7,1,11,0,919,926
97464,7,1,11,0,919,926
113554,8,1,11,0,919,927
121288,7,4,11,0,919,926
13631,14,1,11,0,920,934
24609,5,3,11,0,920,925
32494,14,1,11,0,920,934
44724,46,4,11,0,920,966
46574,14,1,11,0,920,934
57884,14,1,11,0,920,934
59831,5,2,11,0,920,925
64926,14,1,11,0,920,934
69833,14,1,11,0,920,934
72709,14,1,11,0,920,934
96561,14,1,11,0,920,934
97209,14,1,11,0,920,934
109897,14,1,11,0,920,934
119199,14,1,11,0,920,934
128152,14,1,11,0,920,934
27196,36,1,11,0,921,957
39782,35,1,11,0,921,956
62365,14,7,11,0,921,935
63578,3,1,11,0,921,924
68347,39,1,11,1,921,960
19442,9,2,11,0,922,931
21639,37,2,11,1,922,959
77753,15,3,11,0,922,937
79872,24,1,11,1,922,946
85183,26,4,11,1,922,948
96501,2,1,11,0,922,924
102880,15,1,11,0,922,937
119061,14,1,11,0,923,937
18409,3,1,11,1,924,927
93136,22,1,11,1,924,946
93893,22,1,11,1,924,946
95093,22,3,11,1,924,946
104386,22,1,11,1,924,946
112710,14,1,11,0,924,938
114480,39,2,11,1,924,963
116876,22,1,11,1,924,946
7551,9,1,11,0,925,934
14711,10,1,11,0,925,935
21125,66,1,12,0,925,991
41252,27,2,11,0,925,952
41256,52,5,11,0,925,977
59596,10,1,11,0,925,935
61569,27,1,11,0,925,952
63889,50,2,11,1,925,975
80788,6,7,11,0,925,931
83415,10,1,11,0,925,935
84452,36,4,11,0,925,961
85995,9,3,11,0,925,934
90486,9,1,11,0,925,934
104875,66,1,12,0,925,991
110852,66,1,12,0,925,991
26315,47,2,11,1,926,973
41488,45,2,11,1,926,971
47606,3,3,11,0,926,929
64720,10,2,11,0,926,936
87341,6,1,11,0,926,932
125200,47,2,11,1,926,973
54851,16,2,11,1,927,943
54856,16,1,11,0,927,943
55899,16,9,11,1,927,943
59772,16,2,11,1,927,943
61103,16,1,11,1,927,943
69666,3,3,11,1,927,930
71266,16,3,11,1,927,943
73114,16,1,11,1,927,943
74465,16,1,11,1,927,943
77628,16,3,11,1,927,943
77636,16,1,11,1,927,943
82555,16,1,11,1,927,943
84728,16,2,11,1,927,943
88534,16,3,11,1,927,943
106217,16,1,11,1,927,943
114048,16,5,11,1,927,943
116661,16,1,11,1,927,943
117206,83,4,12,1,927,1010
118048,3,1,11,1,927,930
125988,16,1,11,1,927,943
127704,44,3,11,1,927,971
129383,16,1,11,1,927,943
33184,46,2,11,1,928,974
37960,5,2,11,0,928,933
52802,15,1,11,0,928,943
106408,14,4,11,1,928,942
109607,29,1,11,0,928,957
125749,2,2,11,1,928,930
26265,62,2,12,0,929,991
28351,27,1,11,0,929,956
78554,22,7,11,1,929,951
25646,17,2,11,1,930,947
42725,38,2,11,1,930,968
52322,25,1,11,0,930,955
105483,17,1,11,1,930,947
124152,39,1,11,1,930,969
129125,39,1,11,1,930,969
129863,37,1,11,1,930,967
9312,8,1,11,0,931,939
12687,25,6,11,0,931,956
17427,23,1,11,0,931,954
17752,8,1,11,0,931,939
18015,4,3,11,0,931,935
23228,8,2,11,0,931,939
29693,25,1,11,0,931,956
46217,4,1,11,0,931,935
50962,23,1,11,0,931,954
58262,21,1,11,0,931,952
62687,8,1,11,0,931,939
63837,43,2,11,1,931,974
64285,16,4,11,1,931,947
65615,8,2,11,0,931,939
67511,23,2,11,0,931,954
83705,3,1,11,1,931,934
85318,8,1,11,0,931,939
93630,23,1,11,0,931,954
96962,3,3,11,1,931,934
102425,3,1,11,0,931,934
103882,5,2,11,1,931,936
104160,38,3,11,1,931,969
118051,37,2,11,1,931,968
124780,8,1,11,0,931,939
126668,60,1,12,0,931,991
126871,23,1,11,0,931,954
7909,2,7,11,0,932,934
9000,23,1,11,0,932,955
13336,23,1,11,0,932,955
23206,23,1,11,0,932,955
23400,23,3,11,0,932,955
29205,23,1,11,0,932,955
31458,10,1,11,0,932,942
35610,23,1,11,0,932,955
51543,22,1,11,0,932,954
55165,23,1,11,0,932,955
61090,23,1,11,0,932,955
64517,23,1,11,0,932,955
69023,23,2,11,0,932,955
70144,23,2,11,0,932,955
72148,23,2,11,0,932,955
79287,23,1,11,0,932,955
90594,23,1,11,0,932,955
93381,23,1,11,0,932,955
95127,23,2,11,0,932,955
97865,63,2,12,0,932,995
98245,23,1,11,0,932,955
103881,23,4,11,0,932,955
105752,20,5,11,0,932,952
107728,23,1,11,0,932,955
122541,6,4,11,1,932,938
127469,4,5,11,1,932,936
10940,13,2,11,1,933,946
20593,4,1,11,0,933,937
20997,39,1,11,1,933,972
28892,29,1,11,1,933,962
48964,2,1,11,0,933,935
61199,22,1,11,0,933,955
68507,39,2,11,1,933,972
80592,24,1,11,0,933,957
90138,2,6,11,1,933,935
6874,15,1,11,0,934,949
10751,97,1,13,0,934,1031
18552,29,1,11,1,934,963
23728,17,1,11,0,934,951
29348,17,1,11,0,934,951
31521,15,1,11,0,934,949
32882,17,1,11,0,934,951
36353,17,1,11,0,934,951
36482,17,1,11,0,934,951
37296,15,1,11,0,934,949
40363,17,1,11,0,934,951
41617,17,1,11,0,934,951
41847,29,1,11,1,934,963
42370,17,1,11,0,934,951
43525,17,1,11,0,934,951
45055,13,1,11,0,934,947
45216,15,1,11,0,934,949
46921,8,6,11,1,934,942
50619,17,1,11,0,934,951
56064,17,1,11,0,934,951
60662,97,1,13,0,934,1031
62537,97,1,13,0,934,1031
63242,9,1,11,1,934,943
70474,10,4,11,1,934,944
71147,17,1,11,0,934,951
79677,17,1,11,0,934,951
82320,29,1,11,1,934,963
84073,17,1,11,0,934,951
86649,17,1,11,0,934,951
91011,17,1,11,0,934,951
93949,98,1,13,0,934,1032
95070,97,1,13,0,934,1031
102545,17,1,11,0,934,951
105925,30,1,11,0,934,964
107894,93,2,13,0,934,1027
108421,17,1,11,0,934,951
112345,101,4,13,0,934,1035
114662,17,1,11,0,934,951
115490,19,3,11,0,934,953
115915,98,1,13,0,934,1032
124700,30,3,11,0,934,964
9461,17,1,11,0,935,952
11409,56,1,12,0,935,991
12748,17,1,11,0,935,952
14949,17,4,11,0,935,952
15114,13,1,11,0,935,948
17385,17,2,11,0,935,952
18985,17,1,11,0,935,952
22135,17,4,11,0,935,952
24118,56,2,12,0,935,991
24388,17,1,11,0,935,952
24410,17,1,11,0,935,952
25692,17,1,11,0,935,952
30471,17,1,11,0,935,952
31604,3,5,11,0,935,938
31670,17,1,11,0,935,952
31789,17,1,11,0,935,952
32086,17,3,11,0,935,952
32358,56,1,12,0,935,991
35756,17,1,11,0,935,952
36168,56,1,12,0,935,991
36855,13,1,11,0,935,948
39560,56,7,12,0,935,991
40886,17,2,11,0,935,952
42075,56,1,12,0,935,991
46757,17,4,11,0,935,952
47606,17,4,11,0,935,952
50117,13,2,11,0,935,948
51653,17,2,11,0,935,952
54571,17,1,11,0,935,952
58487,13,1,11,0,935,948
60320,13,1,11,0,935,948
66734,17,1,11,0,935,952
68781,17,1,11,0,935,952
69803,17,3,11,0,935,952
70680,17,2,11,0,935,952
70848,17,1,11,0,935,952
73977,17,1,11,0,935,952
74324,56,1,12,0,935,991
79292,16,1,11,0,935,951
82476,17,1,11,0,935,952
83517,17,1,11,0,935,952
85769,17,1,11,0,935,952
86576,17,1,11,0,935,952
87645,17,1,11,0,935,952
89537,17,1,11,0,935,952
89786,13,1,11,0,935,948
90891,27,1,11,1,935,962
91161,17,1,11,0,935,952
94756,17,1,11,0,935,952
97654,17,1,11,0,935,952
98873,56,1,12,0,935,991
101140,7,1,11,0,935,942
101350,17,1,11,0,935,952
103515,17,1,11,0,935,952
104285,17,1,11,0,935,952
105657,27,1,11,1,935,962
106544,17,1,11,0,935,952
107432,56,1,12,0,935,991
107760,17,2,11,0,935,952
109498,13,1,11,0,935,948
109661,17,1,11,0,935,952
110601,56,1,12,0,935,991
112453,18,1,11,0,935,953
116863,56,1,12,0,935,991
118716,17,2,11,0,935,952
118864,56,1,12,0,935,991
119263,56,1,12,0,935,991
120281,29,3,11,1,935,964
120751,17,4,11,0,935,952
122063,17,1,11,0,935,952
128052,25,5,11,1,935,960
128315,17,1,11,0,935,952
7724,27,1,11,1,936,963
11488,55,1,12,0,936,991
18118,13,3,11,0,936,949
28318,17,3,11,0,936,953
51580,13,2,11,0,936,949
73222,65,2,12,1,936,1001
79443,18,1,11,0,936,954
90877,28,2,11,1,936,964
96093,15,1,11,0,936,951
96208,58,1,12,0,936,994
111514,17,1,11,0,936,953
122059,18,1,11,0,936,954
19442,10,3,11,0,937,947
44886,27,3,11,1,937,964
56907,54,1,12,0,937,991
129477,54,1,12,0,937,991
5623,17,1,11,0,938,955
32520,3,1,11,0,938,941
38914,31,1,11,1,938,969
62365,14,8,11,0,938,952
13728,14,3,11,0,939,953
33798,27,1,11,0,939,966
36433,16,1,11,1,939,955
43389,2,1,11,0,939,941
73882,14,1,11,0,939,953
21562,16,1,11,0,940,956
111092,51,1,12,0,940,991
12697,8,1,11,0,941,949
31432,11,1,11,0,941,952
36622,11,1,11,0,941,952
54037,12,3,11,1,941,953
77403,11,1,11,0,941,952
74587,89,1,13,0,942,1031
118052,106,1,13,1,942,1048
129672,14,1,11,1,942,956
18409,3,2,11,1,943,946
21837,13,3,11,1,943,956
74783,53,1,12,1,943,996
120373,53,1,12,1,943,996
22832,10,2,11,0,945,955
123770,9,1,11,0,945,954
23277,6,3,11,1,946,952
124984,17,1,11,1,946,963
7026,6,1,11,0,947,953
20377,44,2,12,0,947,991
76810,47,1,12,0,947,994
94864,36,1,12,0,947,983
103311,6,4,11,0,947,953
106369,24,2,11,0,947,971
5596,5,5,11,0,948,953
13762,5,1,11,0,948,953
20542,5,1,11,0,948,953
21302,5,8,11,0,948,953
21753,5,3,11,0,948,953
34210,5,1,11,0,948,953
38192,5,1,11,0,948,953
40939,5,4,11,0,948,953
42562,5,2,11,0,948,953
43347,5,3,11,0,948,953
53517,5,1,11,0,948,953
76563,5,1,11,0,948,953
76662,5,1,11,0,948,953
77642,5,5,11,0,948,953
81589,5,1,11,0,948,953
81738,5,1,11,1,948,953
85183,5,5,11,1,948,953
86143,5,2,11,0,948,953
86424,4,1,11,0,948,952
91745,5,1,11,0,948,953
93723,5,1,11,0,948,953
105540,5,4,11,0,948,953
108403,5,1,11,0,948,953
108759,5,1,11,0,948,953
112910,5,1,11,0,948,953
117025,5,1,11,0,948,953
118380,5,1,11,0,948,953
119061,5,2,11,0,948,953
119609,5,2,11,0,948,953
122541,3,5,11,1,948,951
34981,42,1,12,0,949,991
58984,42,1,12,0,949,991
62003,42,1,12,0,949,991
66996,3,1,11,0,949,952
78064,4,5,11,0,949,953
86137,42,4,12,0,949,991
89654,42,1,12,0,949,991
90841,42,1,12,0,949,991
36867,41,2,12,0,950,991
74189,15,3,11,1,950,965
35977,9,6,11,1,951,960
102425,3,2,11,0,951,954
118048,16,2,11,1,951,967
16519,78,2,13,0,952,1030
18015,2,4,11,0,952,954
24137,12,3,11,1,952,964
31604,78,6,13,0,952,1030
32520,3,2,11,0,952,955
40945,3,1,11,0,952,955
46217,2,2,11,0,952,954
70126,2,3,11,0,952,954
101140,80,2,13,0,952,1032
119543,78,1,13,0,952,1030
125405,78,1,13,0,952,1030
128945,39,1,12,0,952,991
45055,89,2,13,0,953,1042
120911,74,1,13,0,953,1027
7909,11,8,11,0,955,966
48964,36,2,12,0,955,991
87341,36,2,12,0,955,991
27196,28,2,12,0,960,988
103289,8,2,11,0,960,968
124919,34,1,12,0,960,994
13144,27,3,12,0,961,988
20542,33,2,12,0,961,994
21336,27,2,12,0,961,988
34100,33,7,12,0,961,994
63401,33,2,12,0,961,994
79443,33,2,12,0,961,994
84686,33,2,12,0,961,994
117156,28,1,12,0,961,989
122059,33,2,12,0,961,994
27971,25,4,12,0,962,987
39782,25,2,12,0,962,987
59962,31,3,12,1,962,993
73053,31,5,12,0,962,993
83705,4,2,11,1,962,966
84126,25,1,12,0,962,987
120716,25,3,12,0,962,987
10940,13,3,11,1,963,976
13016,23,3,12,0,963,986
22832,23,3,12,0,963,986
23206,23,2,12,0,963,986
32907,25,3,12,0,963,988
49971,3,6,11,0,963,966
52288,24,11,12,0,963,987
53624,23,1,12,0,963,986
55165,23,2,12,0,963,986
64517,23,2,12,0,963,986
69666,4,4,11,1,963,967
70144,23,3,12,0,963,986
92424,23,2,12,0,963,986
96962,11,4,11,1,963,974
103882,5,3,11,1,963,968
119061,23,3,12,0,963,986
120298,23,1,12,0,963,986
124388,22,1,12,0,963,985
9670,27,3,12,0,964,991
12697,27,2,12,0,964,991
16057,26,3,12,0,964,990
17223,37,2,12,1,964,1001
18118,27,4,12,0,964,991
21909,67,1,13,0,964,1031
25598,27,3,12,0,964,991
27059,27,5,12,0,964,991
27101,27,2,12,0,964,991
30398,27,3,12,0,964,991
38084,27,3,12,0,964,991
39959,26,3,12,0,964,990
40733,27,1,12,0,964,991
41252,25,3,12,0,964,989
42172,27,1,12,0,964,991
46921,2,7,11,1,964,966
47451,27,1,12,0,964,991
51880,27,4,12,0,964,991
54081,27,2,12,0,964,991
59254,27,4,12,0,964,991
61569,23,2,12,0,964,987
64394,23,3,12,0,964,987
65232,27,4,12,0,964,991
66631,27,4,12,0,964,991
67949,27,6,12,0,964,991
68390,27,1,12,0,964,991
68748,26,1,12,0,964,990
70429,24,5,12,0,964,988
89537,27,2,12,0,964,991
91349,27,3,12,0,964,991
97432,27,3,12,0,964,991
105480,27,1,12,0,964,991
106071,27,7,12,0,964,991
110296,27,4,12,0,964,991
114048,2,6,11,1,964,966
128733,27,1,12,0,964,991
129609,27,1,12,0,964,991
39652,23,2,12,0,965,988
54099,4,2,11,1,965,969
57568,23,5,12,0,965,988
81910,23,1,12,0,965,988
83393,23,4,12,0,965,988
90574,25,4,12,0,965,990
100838,23,2,12,0,965,988
11094,17,2,12,0,966,983
13648,17,7,12,0,966,983
14606,19,2,12,0,966,985
14711,17,2,12,0,966,983
18739,17,1,12,0,966,983
19745,17,1,12,0,966,983
24388,17,2,12,0,966,983
32887,17,1,12,0,966,983
37936,17,5,12,0,966,983
39870,27,4,12,1,966,993
50679,17,2,12,0,966,983
59596,17,2,12,0,966,983
62785,17,2,12,0,966,983
70519,14,1,12,0,966,980
73223,17,4,12,0,966,983
73977,17,2,12,0,966,983
83415,17,2,12,0,966,983
85995,17,4,12,0,966,983
89402,17,1,12,0,966,983
96086,17,4,12,0,966,983
97186,17,2,12,0,966,983
97604,17,4,12,0,966,983
97654,17,2,12,0,966,983
107378,17,2,12,0,966,983
107582,17,2,12,0,966,983
118716,17,3,12,0,966,983
127233,17,3,12,0,966,983
128491,17,2,12,0,966,983
59062,18,3,12,0,967,985
81383,34,2,12,1,967,1001
111786,16,3,12,0,967,983
94700,9,1,11,0,968,977
108107,15,2,12,0,968,983
112091,9,1,11,0,968,977
124620,14,4,12,0,968,982
126710,13,8,12,0,968,981
36761,4,1,11,0,969,973
106119,10,2,11,0,969,979
125749,24,3,12,1,969,993
24137,17,4,12,1,974,991
90138,15,7,12,1,976,991
41256,12,6,12,0,979,991
106369,18,3,12,0,979,997
12568,12,1,12,0,981,993
12687,14,7,12,0,981,995
43462,13,5,12,0,981,994
83682,13,5,12,0,981,994
113912,7,3,12,0,981,988
125421,14,4,12,0,981,995
7909,47,9,13,0,983,1030
28708,9,4,12,0,983,992
49971,3,7,12,0,983,986
99968,10,4,12,0,983,993
101352,9,5,12,0,983,992
103246,10,2,12,0,983,993
103289,9,3,12,0,983,992
103311,11,5,12,0,983,994
114048,18,7,12,1,983,1001
33798,45,2,13,0,985,1030
44724,64,5,13,0,985,1049
61370,27,1,12,0,987,1014
63837,2,3,12,0,987,989
75444,3,1,12,0,987,990
129748,2,6,12,0,987,989
103280,4,1,12,0,988,992
39146,23,1,12,0,989,1012
65972,23,1,12,0,989,1012
79140,23,1,12,0,989,1012
80466,23,1,12,0,989,1012
96962,24,5,12,1,989,1013
21302,2,9,12,0,990,992
22832,23,4,12,0,990,1013
23390,23,1,12,0,990,1013
32707,9,1,12,0,990,999
42562,23,3,12,0,990,1013
68347,40,2,13,1,990,1030
86143,23,3,12,0,990,1013
110839,23,1,12,0,990,1013
124951,23,1,12,0,990,1013
13287,38,5,13,0,991,1029
24137,39,5,13,1,991,1030
59831,21,3,12,0,991,1012
84452,3,5,12,0,991,994
105925,38,2,13,0,991,1029
124700,95,4,14,0,991,1086
26315,40,3,13,1,992,1032
102425,17,3,12,0,992,1009
5902,17,1,12,0,993,1010
8821,16,1,12,0,993,1009
9202,17,1,12,0,993,1010
19113,17,1,12,0,993,1010
23322,17,1,12,0,993,1010
27861,17,1,12,0,993,1010
29694,17,1,12,0,993,1010
30905,17,1,12,0,993,1010
33909,19,1,12,0,993,1012
46921,8,8,12,1,993,1001
52561,17,2,12,0,993,1010
54081,17,3,12,0,993,1010
63669,17,3,12,0,993,1010
68503,17,1,12,0,993,1010
69023,17,3,12,0,993,1010
77989,17,1,12,0,993,1010
78131,17,1,12,0,993,1010
80130,17,2,12,0,993,1010
84840,17,2,12,0,993,1010
87200,17,1,12,0,993,1010
94295,17,1,12,0,993,1010
105559,17,1,12,0,993,1010
109538,17,1,12,0,993,1010
115260,17,2,12,0,993,1010
122485,17,3,12,0,993,1010
71685,13,2,12,0,994,1007
29229,13,1,12,0,995,1008
105107,29,2,13,1,996,1025
119061,10,4,12,0,996,1006
86299,11,1,12,0,997,1008
91566,11,1,12,0,997,1008
103289,9,4,12,0,997,1006
103882,24,4,13,1,997,1021
104160,3,4,12,1,997,1000
106832,17,2,12,1,997,1014
109152,16,1,12,0,997,1013
118051,44,3,13,1,997,1041
90138,16,8,12,1,998,1014
127469,3,6,12,1,998,1001
31648,9,1,12,0,999,1008
129672,16,2,12,1,1000,1016
44886,27,4,13,1,1001,1028
66443,9,1,12,0,1001,1010
90877,19,3,13,1,1001,1020
120281,22,4,13,1,1001,1023
125749,12,4,12,1,1003,1015
29444,36,1,13,1,1004,1040
34073,18,1,13,0,1004,1022
63889,154,3,16,1,1004,1158
7724,7,2,12,1,1006,1013
21639,71,3,14,1,1006,1077
38914,151,2,16,1,1006,1157
107637,107,1,15,1,1006,1113
68507,127,3,15,1,1007,1134
84126,68,2,14,0,1007,1075
20997,125,2,15,1,1008,1133
92424,67,3,14,0,1008,1075
21302,4,10,12,0,1009,1013
103280,6,2,12,0,1009,1015
113422,22,1,13,1,1009,1031
126071,105,1,15,1,1010,1115
16151,61,1,14,0,1011,1072
18739,60,2,14,0,1011,1071
21765,59,1,14,0,1011,1070
25672,6,2,12,0,1011,1017
29900,60,1,14,0,1011,1071
31946,60,1,14,0,1011,1071
32887,61,2,14,0,1011,1072
36761,60,2,14,0,1011,1071
39352,60,2,14,0,1011,1071
43885,60,1,14,0,1011,1071
50679,60,3,14,0,1011,1071
52989,17,1,13,0,1011,1028
58649,69,1,14,0,1011,1080
62785,60,3,14,0,1011,1071
70307,60,1,14,0,1011,1071
82476,20,2,13,0,1011,1031
84484,60,1,14,0,1011,1071
129321,69,1,14,0,1011,1080
39782,12,3,13,0,1013,1025
59215,2,1,12,0,1013,1015
42725,35,3,13,1,1014,1049
61688,35,1,13,0,1014,1049
124152,54,2,14,1,1014,1068
84518,123,1,15,1,1015,1138
105172,4,1,12,1,1015,1019
70705,19,1,13,1,1016,1035
106832,14,3,13,1,1016,1030
33184,136,3,16,1,1017,1153
63837,12,4,13,1,1017,1029
70770,76,2,14,1,1017,1093
36368,133,2,16,1,1018,1151
77628,16,4,13,1,1018,1034
94854,12,2,13,0,1019,1031
117248,32,1,13,0,1019,1051
7644,20,1,13,0,1020,1040
46921,8,9,13,1,1020,1028
69666,4,5,13,1,1020,1024
78488,18,3,13,1,1020,1038
117206,54,5,14,1,1020,1074
96962,3,6,13,1,1021,1024
99525,16,2,13,1,1021,1037
104160,4,5,13,1,1021,1025
13123,29,1,13,0,1022,1051
6398,12,1,13,0,1023,1035
21753,5,4,13,1,1023,1028
54650,13,3,13,0,1023,1036
81738,49,2,14,1,1023,1072
99952,12,1,13,0,1023,1035
116661,12,2,13,0,1023,1035
11444,6,1,13,1,1024,1030
13418,12,2,13,0,1024,1036
23771,39,1,14,0,1024,1063
32707,68,2,14,0,1024,1092
101210,4,1,13,0,1024,1028
117721,16,1,13,1,1024,1040
123271,46,5,14,1,1024,1070
14923,47,1,14,0,1025,1072
16644,44,1,14,0,1025,1069
36866,38,1,14,0,1025,1063
46815,2,1,13,1,1025,1027
51849,8,2,13,0,1025,1033
82588,29,1,13,0,1025,1054
94750,8,3,13,0,1025,1033
103881,35,5,14,0,1025,1060
116699,23,2,13,0,1025,1048
117156,45,2,14,0,1025,1070
123968,26,1,13,0,1025,1051
10911,27,1,13,0,1026,1053
20542,43,3,14,0,1026,1069
27196,70,3,14,0,1026,1096
29693,66,2,14,0,1026,1092
34210,2,2,13,0,1026,1028
36402,27,1,13,0,1026,1053
36927,29,1,13,0,1026,1055
38084,4,4,13,0,1026,1030
71903,145,3,16,0,1026,1171
76810,43,2,14,0,1026,1069
80916,41,1,14,0,1026,1067
96208,39,2,14,0,1026,1065
118291,13,1,13,0,1026,1039
121930,41,1,14,0,1026,1067
124919,27,2,13,0,1026,1053
6062,4,1,13,0,1027,1031
9812,39,1,14,0,1027,1066
11043,25,5,13,0,1027,1052
11255,39,1,14,0,1027,1066
13016,3,4,13,0,1027,1030
13465,39,1,14,0,1027,1066
14668,39,1,14,0,1027,1066
15619,39,1,14,0,1027,1066
17292,39,1,14,0,1027,1066
20287,39,1,14,0,1027,1066
20699,33,4,14,0,1027,1060
21014,26,1,13,0,1027,1053
21251,39,1,14,0,1027,1066
22832,33,5,14,0,1027,1060
23206,63,3,14,0,1027,1090
23937,39,1,14,0,1027,1066
24367,39,1,14,0,1027,1066
24699,39,1,14,0,1027,1066
25601,39,1,14,0,1027,1066
26858,39,1,14,0,1027,1066
28049,39,1,14,0,1027,1066
28140,39,1,14,0,1027,1066
29986,39,1,14,0,1027,1066
30525,39,1,14,0,1027,1066
31208,39,1,14,0,1027,1066
32086,39,4,14,0,1027,1066
33698,39,1,14,0,1027,1066
34290,21,1,13,0,1027,1048
36942,39,1,14,0,1027,1066
40175,39,1,14,0,1027,1066
42539,39,1,14,0,1027,1066
43434,39,1,14,0,1027,1066
48964,2,3,13,0,1027,1029
51771,39,1,14,0,1027,1066
51855,8,1,13,0,1027,1035
53308,39,1,14,0,1027,1066
53452,39,1,14,0,1027,1066
53624,18,2,13,0,1027,1045
54403,39,1,14,0,1027,1066
55165,63,3,14,0,1027,1090
55732,39,1,14,0,1027,1066
55774,39,1,14,0,1027,1066
58516,39,1,14,0,1027,1066
59028,9,3,13,0,1027,1036
61103,39,2,14,0,1027,1066
64372,39,1,14,0,1027,1066
64517,63,3,14,0,1027,1090
64727,39,1,14,0,1027,1066
66363,39,1,14,0,1027,1066
67618,39,1,14,0,1027,1066
68731,3,2,13,0,1027,1030
68909,39,1,14,0,1027,1066
69330,15,4,13,0,1027,1042
69850,39,1,14,0,1027,1066
70126,3,4,13,0,1027,1030
70680,4,3,13,0,1027,1031
71056,39,1,14,0,1027,1066
71343,4,1,13,0,1027,1031
73053,15,6,13,0,1027,1042
73882,26,2,13,0,1027,1053
76454,39,1,14,0,1027,1066
77191,39,1,14,0,1027,1066
79443,34,3,14,0,1027,1061
80360,39,1,14,0,1027,1066
81381,37,2,14,0,1027,1064
81587,39,1,14,0,1027,1066
82110,39,1,14,0,1027,1066
83063,46,4,14,0,1027,1073
83289,39,1,14,0,1027,1066
84274,39,4,14,0,1027,1066
84452,39,6,14,0,1027,1066
84645,39,1,14,0,1027,1066
85183,4,6,13,0,1027,1031
86102,54,1,14,0,1027,1081
87645,3,2,13,0,1027,1030
88376,39,1,14,0,1027,1066
91782,4,2,13,0,1027,1031
92070,39,1,14,0,1027,1066
92512,39,1,14,0,1027,1066
93484,4,2,13,0,1027,1031
95045,4,1,13,0,1027,1031
95246,38,1,14,0,1027,1065
99851,39,1,14,0,1027,1066
101486,4,4,13,0,1027,1031
103058,39,1,14,0,1027,1066
103317,39,1,14,0,1027,1066
103846,39,1,14,0,1027,1066
104573,39,1,14,0,1027,1066
105609,25,1,13,0,1027,1052
106178,4,1,13,0,1027,1031
106330,39,1,14,0,1027,1066
106332,4,1,13,0,1027,1031
106808,47,2,14,1,1027,1074
107533,39,1,14,0,1027,1066
108808,5,4,13,0,1027,1032
111879,39,1,14,0,1027,1066
111929,39,1,14,0,1027,1066
111935,39,1,14,0,1027,1066
114097,41,2,14,0,1027,1068
115973,25,1,13,0,1027,1052
116778,39,1,14,0,1027,1066
117794,25,1,13,0,1027,1052
117823,39,1,14,0,1027,1066
118053,3,3,13,0,1027,1030
118637,4,4,13,0,1027,1031
119337,39,1,14,0,1027,1066
119792,39,1,14,0,1027,1066
120104,39,1,14,0,1027,1066
120298,4,2,13,0,1027,1031
120716,20,4,13,0,1027,1047
121114,39,1,14,0,1027,1066
121849,39,8,14,0,1027,1066
122059,53,3,14,0,1027,1080
122638,39,1,14,0,1027,1066
123679,39,1,14,0,1027,1066
123770,53,2,14,0,1027,1080
124002,4,1,13,0,1027,1031
124388,93,2,15,0,1027,1120
125754,39,1,14,0,1027,1066
125872,36,1,14,0,1027,1063
127266,4,1,13,0,1027,1031
127614,4,1,13,0,1027,1031
128793,39,1,14,0,1027,1066
5546,3,2,13,0,1028,1031
8018,23,1,13,0,1028,1051
9047,23,1,13,0,1028,1051
12748,23,2,13,0,1028,1051
14591,23,1,13,0,1028,1051
14829,23,1,13,0,1028,1051
17146,23,1,13,0,1028,1051
18021,23,1,13,0,1028,1051
21277,3,1,13,0,1028,1031
21836,23,1,13,0,1028,1051
22889,29,1,13,0,1028,1057
24725,23,1,13,0,1028,1051
26753,31,1,13,0,1028,1059
27560,23,1,13,0,1028,1051
28318,2,4,13,0,1028,1030
28486,23,1,13,0,1028,1051
34990,23,1,13,0,1028,1051
35849,23,1,13,0,1028,1051
36482,23,2,13,0,1028,1051
38220,23,1,13,0,1028,1051
38620,23,1,13,0,1028,1051
38688,29,1,13,1,1028,1057
40298,23,1,13,0,1028,1051
40759,23,1,13,0,1028,1051
42788,23,1,13,0,1028,1051
43256,23,1,13,0,1028,1051
43867,23,1,13,0,1028,1051
44828,23,1,13,0,1028,1051
48394,23,1,13,0,1028,1051
50574,3,1,13,0,1028,1031
53893,23,1,13,0,1028,1051
54636,23,1,13,0,1028,1051
54656,23,1,13,0,1028,1051
59772,4,3,13,1,1028,1032
61199,62,2,14,0,1028,1090
62145,23,1,13,0,1028,1051
62159,23,1,13,0,1028,1051
62493,3,1,13,0,1028,1031
62511,8,3,13,0,1028,1036
63212,29,1,13,0,1028,1057
64438,31,1,13,0,1028,1059
64956,79,1,15,0,1028,1107
65229,32,1,14,0,1028,1060
68054,23,1,13,0,1028,1051
68327,94,1,15,0,1028,1122
70038,23,1,13,0,1028,1051
70400,3,3,13,0,1028,1031
71789,23,1,13,0,1028,1051
74465,23,2,13,0,1028,1051
76001,23,1,13,0,1028,1051
77642,2,6,13,0,1028,1030
78111,23,1,13,0,1028,1051
78554,23,8,13,0,1028,1051
78604,3,1,13,0,1028,1031
85814,3,1,13,0,1028,1031
88746,23,1,13,0,1028,1051
89883,31,1,13,0,1028,1059
90735,23,1,13,0,1028,1051
92351,3,1,13,0,1028,1031
94907,23,1,13,0,1028,1051
95827,20,1,13,0,1028,1048
99246,23,1,13,0,1028,1051
99990,23,1,13,0,1028,1051
100728,31,1,13,0,1028,1059
101466,3,7,13,0,1028,1031
109661,29,2,13,1,1028,1057
109697,23,1,13,0,1028,1051
110919,23,1,13,0,1028,1051
111238,23,1,13,0,1028,1051
111514,60,2,14,0,1028,1088
115490,44,4,14,0,1028,1072
119707,3,1,13,0,1028,1031
121439,23,1,13,0,1028,1051
123751,23,1,13,0,1028,1051
126157,23,1,13,0,1028,1051
128027,3,1,13,0,1028,1031
128187,23,1,13,0,1028,1051
129373,2,1,13,0,1028,1030
129672,4,3,13,1,1028,1032
5596,48,6,14,0,1029,1077
6262,20,1,13,0,1029,1049
9670,21,4,13,0,1029,1050
11409,34,2,14,0,1029,1063
13762,43,2,14,0,1029,1072
20245,19,1,13,0,1029,1048
20377,25,3,13,0,1029,1054
21015,20,2,13,0,1029,1049
21201,39,1,14,0,1029,1068
21336,19,3,13,0,1029,1048
23400,49,4,14,0,1029,1078
24118,34,3,14,0,1029,1063
25035,37,1,14,0,1029,1066
26775,38,1,14,0,1029,1067
30928,38,1,14,0,1029,1067
31957,39,2,14,0,1029,1068
32358,34,2,14,0,1029,1063
33129,14,1,13,0,1029,1043
35832,54,1,14,1,1029,1083
36168,34,2,14,0,1029,1063
36867,3,3,13,0,1029,1032
37042,51,1,14,1,1029,1080
38192,44,2,14,0,1029,1073
39453,17,2,13,0,1029,1046
39560,34,8,14,0,1029,1063
40939,41,5,14,0,1029,1070
42075,35,2,14,0,1029,1064
43347,15,4,13,0,1029,1044
47451,20,2,13,0,1029,1049
48242,38,1,14,0,1029,1067
49257,22,1,13,0,1029,1051
53517,40,2,14,0,1029,1069
55046,38,1,14,0,1029,1067
56907,38,2,14,0,1029,1067
57493,34,1,14,0,1029,1063
57971,15,1,13,0,1029,1044
58984,2,2,13,0,1029,1031
62003,34,2,14,0,1029,1063
65232,37,5,14,0,1029,1066
67806,3,1,13,0,1029,1032
68390,41,2,14,0,1029,1070
69091,42,1,14,0,1029,1071
71531,40,1,14,0,1029,1069
74324,35,2,14,0,1029,1064
75214,62,1,14,0,1029,1091
77753,79,4,15,0,1029,1108
81383,37,3,14,1,1029,1066
83415,47,3,14,0,1029,1076
86137,34,5,14,0,1029,1063
87004,37,2,14,0,1029,1066
88411,22,2,13,0,1029,1051
88901,38,1,14,0,1029,1067
89654,34,2,14,0,1029,1063
90841,3,2,13,0,1029,1032
93476,52,2,14,1,1029,1081
93723,78,2,15,0,1029,1107
95662,3,3,13,0,1029,1032
98873,35,2,14,0,1029,1064
100838,45,3,14,0,1029,1074
105107,54,3,14,1,1029,1083
107432,34,2,14,0,1029,1063
109467,2,1,13,0,1029,1031
110601,34,2,14,0,1029,1063
111712,4,1,13,0,1029,1033
112453,61,2,14,0,1029,1090
116863,34,2,14,0,1029,1063
117025,40,2,14,0,1029,1069
118864,26,2,13,0,1029,1055
119057,14,1,13,0,1029,1043
119061,58,5,14,0,1029,1087
119263,29,2,13,0,1029,1058
120942,38,1,14,0,1029,1067
122331,2,1,13,0,1029,1031
127133,32,1,14,0,1029,1061
127469,29,7,13,1,1029,1058
128733,20,2,13,0,1029,1049
128945,37,2,14,0,1029,1066
129477,2,2,13,0,1029,1031
129609,39,2,14,0,1029,1068
129748,2,7,13,0,1029,1031
11103,13,1,13,0,1030,1043
11488,5,2,13,0,1030,1035
12697,18,3,13,1,1030,1048
14606,21,3,13,0,1030,1051
14711,45,3,14,0,1030,1075
16057,20,4,13,0,1030,1050
17385,13,3,13,0,1030,1043
19745,57,2,14,0,1030,1087
20231,13,1,13,0,1030,1043
20566,13,1,13,0,1030,1043
21125,57,2,14,0,1030,1087
22135,43,5,14,0,1030,1073
23202,27,3,13,1,1030,1057
24388,30,3,14,0,1030,1060
25692,55,2,14,0,1030,1085
26265,57,3,14,0,1030,1087
27665,2,1,13,0,1030,1032
29527,50,1,14,0,1030,1080
30865,32,2,14,0,1030,1062
31670,30,2,14,0,1030,1060
32404,47,1,14,0,1030,1077
34981,49,2,14,0,1030,1079
35977,49,7,14,1,1030,1079
37156,3,1,13,0,1030,1033
37936,21,6,13,0,1030,1051
39959,20,4,13,0,1030,1050
40733,21,2,13,0,1030,1051
40886,57,3,14,0,1030,1087
41252,5,4,13,0,1030,1035
41256,57,7,14,0,1030,1087
43520,21,2,13,0,1030,1051
45206,13,1,13,0,1030,1043
46217,33,3,14,0,1030,1063
46757,57,5,14,0,1030,1087
49542,34,2,14,0,1030,1064
52288,17,12,13,0,1030,1047
54081,20,4,13,0,1030,1050
54571,44,2,14,0,1030,1074
55237,20,4,13,0,1030,1050
59394,21,2,13,0,1030,1051
61569,21,3,13,0,1030,1051
65803,74,3,15,0,1030,1104
68180,21,9,13,0,1030,1051
68748,20,2,13,0,1030,1050
69803,18,4,13,0,1030,1048
71282,13,7,13,0,1030,1043
71285,21,4,13,0,1030,1051
73223,45,5,14,0,1030,1075
73369,23,2,13,0,1030,1053
73977,57,3,14,0,1030,1087
83517,33,2,14,0,1030,1063
83705,15,3,13,1,1030,1045
84591,57,1,14,0,1030,1087
85769,46,2,14,0,1030,1076
87341,2,3,13,0,1030,1032
87380,20,1,13,0,1030,1050
89402,31,2,14,0,1030,1061
89537,21,3,13,0,1030,1051
90138,33,9,14,1,1030,1063
91314,12,1,13,0,1030,1042
92170,13,3,13,0,1030,1043
93481,13,1,13,0,1030,1043
94756,45,2,14,0,1030,1075
97186,21,3,13,0,1030,1051
97654,2,3,13,0,1030,1032
98049,13,1,13,0,1030,1043
98176,20,1,13,0,1030,1050
98216,17,1,13,0,1030,1047
101350,55,2,14,0,1030,1085
104285,16,2,13,0,1030,1046
104875,5,2,13,0,1030,1035
105657,15,2,13,1,1030,1045
106928,2,1,13,0,1030,1032
106977,26,2,13,0,1030,1056
107378,4,3,13,0,1030,1034
107582,21,3,13,0,1030,1051
110852,57,2,14,0,1030,1087
111092,45,2,14,0,1030,1075
111784,38,4,14,0,1030,1068
114271,13,1,13,0,1030,1043
116411,33,1,14,0,1030,1063
119583,34,2,14,0,1030,1064
121920,16,4,13,0,1030,1046
123136,6,1,13,0,1030,1036
124404,30,2,14,0,1030,1060
126668,57,2,14,0,1030,1087
127233,7,4,13,0,1030,1037
128122,13,1,13,0,1030,1043
128370,56,1,14,0,1030,1086
128491,4,3,13,0,1030,1034
5781,17,2,13,0,1031,1048
5886,17,1,13,0,1031,1048
5902,32,2,14,0,1031,1063
6098,32,1,14,0,1031,1063
6710,17,1,13,0,1031,1048
6716,32,1,14,0,1031,1063
6758,17,1,13,0,1031,1048
6867,56,1,14,0,1031,1087
6902,17,1,13,0,1031,1048
6980,32,9,14,0,1031,1063
7342,17,1,13,0,1031,1048
7604,32,1,14,0,1031,1063
7940,32,1,14,0,1031,1063
8111,32,2,14,0,1031,1063
8476,32,1,14,0,1031,1063
8544,32,1,14,0,1031,1063
9605,17,1,13,0,1031,1048
9723,17,4,13,0,1031,1048
10135,17,1,13,0,1031,1048
10509,32,1,14,0,1031,1063
10807,32,1,14,0,1031,1063
11884,32,1,14,0,1031,1063
12013,17,1,13,0,1031,1048
12369,17,5,13,0,1031,1048
12722,17,1,13,0,1031,1048
13414,17,1,13,0,1031,1048
13454,17,1,13,0,1031,1048
13587,18,5,13,0,1031,1049
14076,17,1,13,0,1031,1048
14749,32,1,14,0,1031,1063
14905,32,1,14,0,1031,1063
15515,32,1,14,0,1031,1063
15531,32,1,14,0,1031,1063
16022,17,1,13,0,1031,1048
16559,32,1,14,0,1031,1063
16626,17,1,13,0,1031,1048
16660,32,1,14,0,1031,1063
16697,17,1,13,0,1031,1048
16879,32,1,14,0,1031,1063
16914,32,1,14,0,1031,1063
16956,32,1,14,0,1031,1063
17316,32,1,14,0,1031,1063
17620,17,1,13,0,1031,1048
17760,17,1,13,0,1031,1048
18167,17,1,13,0,1031,1048
18985,32,2,14,0,1031,1063
19112,32,1,14,0,1031,1063
19173,35,1,14,0,1031,1066
19228,17,1,13,0,1031,1048
19282,17,1,13,0,1031,1048
19621,32,1,14,0,1031,1063
20115,42,1,14,0,1031,1073
20163,32,4,14,0,1031,1063
20176,35,1,14,0,1031,1066
20279,32,1,14,0,1031,1063
20603,29,2,14,0,1031,1060
20961,32,1,14,0,1031,1063
20982,31,1,14,0,1031,1062
21472,32,1,14,0,1031,1063
21513,32,1,14,0,1031,1063
21530,32,1,14,0,1031,1063
22211,17,1,13,0,1031,1048
22258,17,1,13,0,1031,1048
22454,17,1,13,0,1031,1048
22910,17,1,13,0,1031,1048
23116,32,1,14,0,1031,1063
23135,3,1,13,0,1031,1034
23816,32,1,14,0,1031,1063
23918,32,1,14,0,1031,1063
24433,32,1,14,0,1031,1063
24442,32,1,14,0,1031,1063
24585,4,2,13,0,1031,1035
24754,32,2,14,0,1031,1063
24851,32,1,14,0,1031,1063
25442,32,1,14,0,1031,1063
25550,17,1,13,0,1031,1048
25598,32,4,14,0,1031,1063
25823,32,1,14,0,1031,1063
26017,19,1,13,0,1031,1050
26447,32,1,14,0,1031,1063
26565,17,1,13,0,1031,1048
26695,32,1,14,0,1031,1063
27035,17,1,13,0,1031,1048
27102,17,1,13,0,1031,1048
27234,17,1,13,0,1031,1048
27739,32,1,14,0,1031,1063
27869,17,1,13,0,1031,1048
28472,17,1,13,0,1031,1048
28691,32,1,14,0,1031,1063
28828,32,1,14,0,1031,1063
28868,17,2,13,0,1031,1048
29081,17,1,13,0,1031,1048
29229,39,2,14,0,1031,1070
29471,17,1,13,0,1031,1048
30177,17,1,13,0,1031,1048
30398,32,4,14,0,1031,1063
30773,32,1,14,0,1031,1063
30982,17,1,13,0,1031,1048
31092,3,1,13,0,1031,1034
31261,17,1,13,0,1031,1048
31295,32,1,14,0,1031,1063
31401,32,1,14,0,1031,1063
31431,17,1,13,0,1031,1048
31988,17,1,13,0,1031,1048
32078,32,1,14,0,1031,1063
32165,32,6,14,0,1031,1063
32180,32,1,14,0,1031,1063
32957,32,1,14,0,1031,1063
33015,32,1,14,0,1031,1063
33069,17,1,13,0,1031,1048
33819,17,1,13,0,1031,1048
34063,17,1,13,0,1031,1048
34073,32,2,14,0,1031,1063
34324,32,1,14,0,1031,1063
35654,14,1,13,0,1031,1045
36023,47,1,14,0,1031,1078
36098,17,1,13,0,1031,1048
36167,17,2,13,0,1031,1048
36353,17,2,13,0,1031,1048
36574,32,1,14,0,1031,1063
37497,17,1,13,0,1031,1048
37499,17,4,13,0,1031,1048
37656,17,1,13,0,1031,1048
37761,32,1,14,0,1031,1063
37868,17,1,13,0,1031,1048
38098,32,1,14,0,1031,1063
38701,17,2,13,0,1031,1048
38705,32,1,14,0,1031,1063
39078,32,1,14,0,1031,1063
39310,16,1,13,0,1031,1047
39362,17,1,13,0,1031,1048
39375,17,1,13,0,1031,1048
39384,32,1,14,0,1031,1063
39448,32,10,14,0,1031,1063
39712,17,2,13,0,1031,1048
39732,17,1,13,0,1031,1048
40421,17,1,13,0,1031,1048
40432,32,1,14,0,1031,1063
40471,32,1,14,0,1031,1063
40740,73,2,15,0,1031,1104
40843,32,1,14,0,1031,1063
40972,17,1,13,0,1031,1048
41090,17,1,13,0,1031,1048
41312,32,1,14,0,1031,1063
41379,17,1,13,0,1031,1048
41445,17,1,13,0,1031,1048
41611,17,1,13,0,1031,1048
42016,17,1,13,0,1031,1048
42111,17,1,13,0,1031,1048
42270,17,1,13,0,1031,1048
42370,17,2,13,0,1031,1048
42568,32,1,14,0,1031,1063
42765,17,1,13,0,1031,1048
43036,17,1,13,0,1031,1048
43243,17,1,13,0,1031,1048
43755,32,1,14,0,1031,1063
43798,17,1,13,0,1031,1048
44035,20,1,13,0,1031,1051
44130,17,1,13,0,1031,1048
44135,17,1,13,0,1031,1048
44350,17,1,13,0,1031,1048
44403,17,1,13,0,1031,1048
44455,32,1,14,0,1031,1063
44539,32,1,14,0,1031,1063
44670,32,1,14,0,1031,1063
44720,17,1,13,0,1031,1048
44795,32,3,14,0,1031,1063
44825,32,1,14,0,1031,1063
44942,15,2,13,0,1031,1046
45102,17,1,13,0,1031,1048
45118,32,1,14,0,1031,1063
45195,32,1,14,0,1031,1063
45241,32,1,14,0,1031,1063
45456,32,1,14,0,1031,1063
45679,32,1,14,0,1031,1063
46048,32,1,14,0,1031,1063
46309,32,1,14,0,1031,1063
46505,32,1,14,0,1031,1063
46515,32,1,14,0,1031,1063
46814,32,1,14,0,1031,1063
46941,17,2,13,0,1031,1048
47475,32,3,14,0,1031,1063
47496,32,1,14,0,1031,1063
47533,32,1,14,0,1031,1063
47916,56,1,14,0,1031,1087
48274,17,1,13,0,1031,1048
48699,17,1,13,0,1031,1048
48822,32,1,14,0,1031,1063
49216,17,1,13,0,1031,1048
49261,28,1,13,0,1031,1059
49549,32,1,14,0,1031,1063
49573,32,1,14,0,1031,1063
49623,32,3,14,0,1031,1063
50327,32,1,14,0,1031,1063
50701,17,1,13,0,1031,1048
51189,32,1,14,0,1031,1063
51307,32,1,14,0,1031,1063
51316,32,1,14,0,1031,1063
51376,32,1,14,0,1031,1063
51575,32,1,14,0,1031,1063
51665,32,1,14,0,1031,1063
51801,32,2,14,0,1031,1063
52299,32,1,14,0,1031,1063
52524,17,1,13,0,1031,1048
52737,17,1,13,0,1031,1048
52758,32,1,14,0,1031,1063
53539,17,1,13,0,1031,1048
53851,17,1,13,0,1031,1048
54051,29,1,14,0,1031,1060
54458,32,1,14,0,1031,1063
54745,17,1,13,0,1031,1048
54851,14,3,13,0,1031,1045
54869,17,1,13,0,1031,1048
55297,32,2,14,0,1031,1063
55511,32,1,14,0,1031,1063
55894,15,1,13,0,1031,1046
56014,17,1,13,0,1031,1048
56180,17,1,13,0,1031,1048
56199,32,1,14,0,1031,1063
56200,17,1,13,0,1031,1048
56593,17,1,13,0,1031,1048
56764,17,1,13,0,1031,1048
56900,32,1,14,0,1031,1063
57029,32,1,14,0,1031,1063
57149,17,1,13,0,1031,1048
57780,12,2,13,0,1031,1043
57794,17,1,13,0,1031,1048
58645,17,2,13,0,1031,1048
58738,32,1,14,0,1031,1063
58981,32,1,14,0,1031,1063
59227,32,1,14,0,1031,1063
59759,17,1,13,0,1031,1048
59886,17,1,13,0,1031,1048
59962,9,4,13,1,1031,1040
60456,17,1,13,0,1031,1048
60831,32,1,14,0,1031,1063
60897,17,1,13,0,1031,1048
61082,32,1,14,0,1031,1063
62365,3,9,13,0,1031,1034
62415,17,1,13,0,1031,1048
62655,32,1,14,0,1031,1063
62737,20,1,13,0,1031,1051
63093,32,1,14,0,1031,1063
63167,17,1,13,0,1031,1048
63261,16,2,13,0,1031,1047
63784,32,1,14,0,1031,1063
63833,56,1,14,0,1031,1087
63900,32,1,14,0,1031,1063
63913,32,1,14,0,1031,1063
64132,32,1,14,0,1031,1063
64153,17,1,13,0,1031,1048
65002,32,1,14,0,1031,1063
66128,27,1,13,0,1031,1058
66407,32,1,14,0,1031,1063
66576,32,1,14,0,1031,1063
66630,32,1,14,0,1031,1063
66694,17,1,13,0,1031,1048
66737,17,1,13,0,1031,1048
67220,19,1,13,0,1031,1050
67364,17,1,13,0,1031,1048
67434,17,1,13,0,1031,1048
67825,32,1,14,0,1031,1063
67869,56,2,14,0,1031,1087
68343,32,1,14,0,1031,1063
68463,17,1,13,0,1031,1048
68634,17,1,13,0,1031,1048
68711,32,1,14,0,1031,1063
68722,32,1,14,0,1031,1063
68922,32,1,14,0,1031,1063
69810,32,1,14,0,1031,1063
69887,32,1,14,0,1031,1063
71025,17,1,13,0,1031,1048
71168,32,1,14,0,1031,1063
71302,17,1,13,0,1031,1048
71696,32,1,14,0,1031,1063
71951,17,1,13,0,1031,1048
72337,32,1,14,0,1031,1063
72358,17,3,13,0,1031,1048
72538,17,1,13,0,1031,1048
72672,32,1,14,0,1031,1063
72791,17,1,13,0,1031,1048
72873,32,1,14,0,1031,1063
72934,17,1,13,0,1031,1048
73184,32,1,14,0,1031,1063
73222,17,3,13,0,1031,1048
73427,22,3,13,0,1031,1053
73963,17,1,13,0,1031,1048
74473,32,1,14,0,1031,1063
74786,17,1,13,0,1031,1048
76798,32,1,14,0,1031,1063
77023,17,1,13,0,1031,1048
77046,32,1,14,0,1031,1063
77049,32,1,14,0,1031,1063
77475,17,1,13,0,1031,1048
77547,17,1,13,0,1031,1048
77834,36,1,14,0,1031,1067
77922,32,1,14,0,1031,1063
78740,2,1,13,0,1031,1033
78974,32,1,14,0,1031,1063
79296,17,1,13,0,1031,1048
79333,11,1,13,0,1031,1042
79445,17,1,13,0,1031,1048
79917,32,1,14,0,1031,1063
80023,32,1,14,0,1031,1063
80068,32,1,14,0,1031,1063
80239,17,1,13,0,1031,1048
80563,32,1,14,0,1031,1063
80756,17,1,13,0,1031,1048
80788,13,8,13,0,1031,1044
80854,32,2,14,0,1031,1063
80910,17,1,13,0,1031,1048
81005,17,1,13,0,1031,1048
81195,17,1,13,0,1031,1048
81416,32,1,14,0,1031,1063
81860,32,1,14,0,1031,1063
81892,32,1,14,0,1031,1063
81948,32,5,14,0,1031,1063
82113,32,1,14,0,1031,1063
82180,32,1,14,0,1031,1063
82507,17,1,13,0,1031,1048
82575,17,1,13,0,1031,1048
82601,32,1,14,0,1031,1063
83000,32,1,14,0,1031,1063
83576,32,1,14,0,1031,1063
83600,17,1,13,0,1031,1048
84259,17,1,13,0,1031,1048
84279,32,1,14,0,1031,1063
84450,17,1,13,0,1031,1048
84566,32,1,14,0,1031,1063
84650,73,1,15,0,1031,1104
84682,17,1,13,0,1031,1048
84798,32,1,14,0,1031,1063
85005,17,1,13,0,1031,1048
85197,32,1,14,0,1031,1063
85206,17,1,13,0,1031,1048
85332,17,1,13,0,1031,1048
85598,32,1,14,0,1031,1063
85936,17,1,13,0,1031,1048
86107,17,1,13,0,1031,1048
86168,17,1,13,0,1031,1048
86344,17,1,13,0,1031,1048
86608,17,1,13,0,1031,1048
86985,32,1,14,0,1031,1063
87152,32,1,14,0,1031,1063
87259,10,1,13,0,1031,1041
87666,32,1,14,0,1031,1063
87702,32,1,14,0,1031,1063
88136,73,2,15,0,1031,1104
88538,17,1,13,0,1031,1048
88698,17,1,13,0,1031,1048
88888,29,1,14,0,1031,1060
89018,32,1,14,0,1031,1063
89222,32,4,14,0,1031,1063
89234,17,1,13,0,1031,1048
90205,17,1,13,0,1031,1048
90211,32,1,14,0,1031,1063
90289,17,1,13,0,1031,1048
90480,17,1,13,0,1031,1048
90594,32,2,14,0,1031,1063
90629,32,1,14,0,1031,1063
90664,32,5,14,0,1031,1063
90848,32,1,14,0,1031,1063
91078,17,1,13,0,1031,1048
91193,17,1,13,0,1031,1048
91684,17,1,13,0,1031,1048
91702,32,1,14,0,1031,1063
92356,3,1,13,0,1031,1034
92506,17,2,13,0,1031,1048
93036,32,1,14,0,1031,1063
93136,17,2,13,0,1031,1048
93819,32,1,14,0,1031,1063
93829,46,1,14,0,1031,1077
93852,17,1,13,0,1031,1048
94105,21,1,13,0,1031,1052
94295,32,2,14,0,1031,1063
94593,32,2,14,0,1031,1063
94694,32,1,14,0,1031,1063
95093,32,4,14,0,1031,1063
95414,32,1,14,0,1031,1063
95599,17,1,13,0,1031,1048
95766,32,1,14,0,1031,1063
95774,32,1,14,0,1031,1063
95946,17,1,13,0,1031,1048
95984,32,1,14,0,1031,1063
96086,17,5,13,0,1031,1048
96129,32,1,14,0,1031,1063
96686,32,3,14,0,1031,1063
97069,17,1,13,0,1031,1048
97379,17,1,13,0,1031,1048
97566,17,1,13,0,1031,1048
97602,32,1,14,0,1031,1063
97861,17,1,13,0,1031,1048
97864,17,1,13,0,1031,1048
98430,17,1,13,0,1031,1048
98681,17,1,13,0,1031,1048
99422,32,1,14,0,1031,1063
100817,17,1,13,0,1031,1048
101124,32,1,14,0,1031,1063
101404,32,1,14,0,1031,1063
102004,17,1,13,0,1031,1048
102572,17,1,13,0,1031,1048
102965,17,1,13,0,1031,1048
102978,32,1,14,0,1031,1063
103154,32,4,14,0,1031,1063
103305,32,1,14,0,1031,1063
103379,17,1,13,0,1031,1048
103409,32,1,14,0,1031,1063
103515,32,2,14,0,1031,1063
103668,4,1,13,0,1031,1035
103904,32,4,14,0,1031,1063
104400,32,1,14,0,1031,1063
104788,32,1,14,0,1031,1063
105330,32,1,14,0,1031,1063
105434,17,3,13,0,1031,1048
105459,17,1,13,0,1031,1048
105752,32,6,14,0,1031,1063
106029,32,1,14,0,1031,1063
106423,32,1,14,0,1031,1063
106542,32,1,14,0,1031,1063
107004,32,1,14,0,1031,1063
107318,17,1,13,0,1031,1048
107468,32,1,14,0,1031,1063
108398,15,2,13,0,1031,1046
108518,32,1,14,0,1031,1063
108603,32,2,14,0,1031,1063
108841,32,1,14,0,1031,1063
108911,32,1,14,0,1031,1063
108947,32,2,14,0,1031,1063
108962,32,1,14,0,1031,1063
109116,32,1,14,0,1031,1063
109253,17,1,13,0,1031,1048
109883,17,1,13,0,1031,1048
110591,32,1,14,0,1031,1063
111186,17,1,13,0,1031,1048
111242,32,1,14,0,1031,1063
111385,32,1,14,0,1031,1063
111435,32,1,14,0,1031,1063
112122,32,1,14,0,1031,1063
112557,32,1,14,0,1031,1063
112905,32,1,14,0,1031,1063
113041,32,1,14,0,1031,1063
113134,17,1,13,0,1031,1048
113176,32,1,14,0,1031,1063
113883,17,1,13,0,1031,1048
113887,35,1,14,0,1031,1066
113892,32,1,14,0,1031,1063
114482,17,1,13,0,1031,1048
114503,17,1,13,0,1031,1048
115062,32,1,14,0,1031,1063
115252,17,1,13,0,1031,1048
115547,17,1,13,0,1031,1048
115771,17,1,13,0,1031,1048
116517,32,1,14,0,1031,1063
116729,4,2,13,0,1031,1035
116999,17,1,13,0,1031,1048
117223,31,1,14,0,1031,1062
118376,32,2,14,0,1031,1063
118693,32,1,14,0,1031,1063
119002,17,1,13,0,1031,1048
119065,17,1,13,0,1031,1048
119117,32,1,14,0,1031,1063
119260,32,1,14,0,1031,1063
119445,17,1,13,0,1031,1048
119931,32,1,14,0,1031,1063
120295,32,3,14,0,1031,1063
120438,17,1,13,0,1031,1048
120602,32,1,14,0,1031,1063
120872,20,1,13,0,1031,1051
121222,32,6,14,0,1031,1063
121560,17,1,13,0,1031,1048
121811,32,1,14,0,1031,1063
121950,32,1,14,0,1031,1063
122362,32,1,14,0,1031,1063
122493,32,1,14,0,1031,1063
122676,17,1,13,0,1031,1048
122805,32,1,14,0,1031,1063
123013,17,1,13,0,1031,1048
123039,17,1,13,0,1031,1048
123494,32,1,14,0,1031,1063
124112,32,1,14,0,1031,1063
124179,32,1,14,0,1031,1063
124549,17,1,13,0,1031,1048
124620,17,5,13,0,1031,1048
125049,12,2,13,0,1031,1043
125134,17,2,13,0,1031,1048
125760,17,1,13,0,1031,1048
126300,17,1,13,0,1031,1048
126710,5,9,13,0,1031,1036
126722,17,1,13,0,1031,1048
126960,17,1,13,0,1031,1048
127042,17,1,13,0,1031,1048
127108,17,1,13,0,1031,1048
127173,32,1,14,0,1031,1063
128908,32,1,14,0,1031,1063
129325,17,1,13,0,1031,1048
129863,17,2,13,0,1031,1048
5971,36,1,14,0,1032,1068
11503,8,1,13,0,1032,1040
12200,72,2,15,0,1032,1104
13611,8,1,13,0,1032,1040
13648,4,8,13,0,1032,1036
14228,8,1,13,0,1032,1040
14949,43,5,14,0,1032,1075
18335,8,4,13,0,1032,1040
18416,30,1,14,0,1032,1062
19096,16,1,13,0,1032,1048
19110,42,1,14,0,1032,1074
24210,48,1,14,0,1032,1080
24332,16,3,13,0,1032,1048
24333,21,1,13,0,1032,1053
24385,8,1,13,0,1032,1040
24609,7,4,13,0,1032,1039
25025,50,2,14,0,1032,1082
29030,16,1,13,0,1032,1048
29627,8,1,13,0,1032,1040
30498,26,1,13,0,1032,1058
33358,8,1,13,0,1032,1040
34652,8,1,13,0,1032,1040
36400,34,1,14,0,1032,1066
37445,29,1,14,0,1032,1061
39433,19,1,13,0,1032,1051
39866,25,1,13,1,1032,1057
41271,28,1,14,0,1032,1060
42562,34,4,14,0,1032,1066
43394,31,1,14,0,1032,1063
43811,42,1,14,0,1032,1074
48722,47,2,14,0,1032,1079
49971,12,8,13,0,1032,1044
50621,17,1,13,0,1032,1049
51653,55,3,14,0,1032,1087
55727,47,2,14,1,1032,1079
55730,62,1,14,0,1032,1094
56396,8,1,13,0,1032,1040
59254,38,5,14,0,1032,1070
61440,2,2,13,0,1032,1034
62025,34,1,14,0,1032,1066
63495,33,1,14,0,1032,1065
65962,8,1,13,0,1032,1040
66996,46,2,14,0,1032,1078
69805,8,1,13,0,1032,1040
71053,12,1,13,0,1032,1044
75241,8,1,13,0,1032,1040
75444,34,2,14,0,1032,1066
78064,13,6,13,0,1032,1045
78090,14,1,13,0,1032,1046
78759,8,1,13,0,1032,1040
79737,10,1,13,0,1032,1042
80179,31,1,14,0,1032,1063
82574,8,1,13,0,1032,1040
85203,8,1,13,0,1032,1040
85756,39,5,14,0,1032,1071
88135,8,1,13,0,1032,1040
88493,42,1,14,0,1032,1074
90234,34,1,14,0,1032,1066
91704,31,1,14,0,1032,1063
92869,31,2,14,0,1032,1063
93998,8,1,13,0,1032,1040
94386,8,1,13,0,1032,1040
95775,28,2,14,0,1032,1060
96093,55,2,14,0,1032,1087
96113,8,1,13,0,1032,1040
97464,34,2,14,0,1032,1066
97996,8,1,13,0,1032,1040
98405,31,5,14,0,1032,1063
99261,34,2,14,0,1032,1066
101507,8,1,13,0,1032,1040
103731,35,2,14,0,1032,1067
104415,17,1,13,0,1032,1049
106095,27,2,13,0,1032,1059
106574,11,3,13,0,1032,1043
109087,9,1,13,0,1032,1041
110435,8,1,13,0,1032,1040
111510,8,1,13,0,1032,1040
113338,45,1,14,0,1032,1077
114163,12,1,13,0,1032,1044
114811,47,2,14,0,1032,1079
117339,62,1,14,0,1032,1094
118151,8,1,13,0,1032,1040
118858,13,2,13,0,1032,1045
119362,8,1,13,0,1032,1040
123043,34,1,14,0,1032,1066
124174,47,1,14,0,1032,1079
124543,32,1,14,0,1032,1064
126330,8,1,13,0,1032,1040
126428,8,1,13,0,1032,1040
127918,43,1,14,0,1032,1075
128334,36,1,14,0,1032,1068
17115,10,2,13,0,1033,1043
17229,10,1,13,0,1033,1043
21570,10,4,13,0,1033,1043
37902,10,1,13,0,1033,1043
43003,10,1,13,0,1033,1043
47466,10,1,13,0,1033,1043
50229,19,1,13,0,1033,1052
52613,101,4,15,1,1033,1134
57391,10,1,13,0,1033,1043
57732,10,8,13,0,1033,1043
69795,2,2,13,0,1033,1035
74573,13,3,13,0,1033,1046
76879,11,6,13,0,1033,1044
81795,8,1,13,0,1033,1041
96602,10,1,13,0,1033,1043
106307,18,3,13,0,1033,1051
109041,24,1,13,0,1033,1057
111781,3,2,13,0,1033,1036
111847,10,1,13,0,1033,1043
123803,10,1,13,0,1033,1043
9000,42,2,14,0,1034,1076
18782,17,2,13,0,1034,1051
21121,13,1,13,0,1034,1047
21277,15,2,13,0,1034,1049
21837,43,4,14,0,1034,1077
32356,16,1,13,0,1034,1050
57893,17,1,13,0,1034,1051
73824,62,1,14,1,1034,1096
99332,26,2,14,0,1034,1060
105165,43,1,14,0,1034,1077
105310,17,1,13,0,1034,1051
107513,43,2,14,0,1034,1077
108403,32,2,14,0,1034,1066
118053,25,4,13,0,1034,1059
120344,52,1,14,0,1034,1086
121394,17,2,13,0,1034,1051
123870,24,2,13,0,1034,1058
16525,8,1,13,0,1035,1043
20153,6,1,13,0,1035,1041
37824,24,2,13,0,1035,1059
50598,29,3,14,0,1035,1064
61190,22,1,13,0,1035,1057
61827,24,3,13,0,1035,1059
72148,25,3,14,0,1035,1060
75153,19,1,13,0,1035,1054
76152,8,4,13,0,1035,1043
88833,6,1,13,0,1035,1041
95494,25,2,14,0,1035,1060
105943,6,2,13,0,1035,1041
106265,24,2,13,0,1035,1059
113750,30,1,14,0,1035,1065
123504,14,1,13,0,1035,1049
126243,6,1,13,0,1035,1041
18015,7,5,13,0,1036,1043
20835,77,1,15,1,1036,1113
26987,15,4,13,0,1036,1051
31026,27,1,14,0,1036,1063
36478,29,1,14,0,1036,1065
40945,22,2,13,0,1036,1058
46098,27,1,14,0,1036,1063
51849,27,3,14,0,1036,1063
55156,36,1,14,0,1036,1072
56064,43,2,14,0,1036,1079
60657,9,1,13,0,1036,1045
63152,27,2,14,0,1036,1063
63669,4,4,13,0,1036,1040
68176,4,1,13,0,1036,1040
72411,43,1,14,0,1036,1079
74721,4,2,13,0,1036,1040
78131,5,2,13,0,1036,1041
78207,4,1,13,0,1036,1040
80989,13,1,13,0,1036,1049
86143,35,4,14,0,1036,1071
87166,15,2,13,0,1036,1051
93673,39,1,14,0,1036,1075
104831,6,4,13,0,1036,1042
109012,7,1,13,0,1036,1043
109413,12,1,13,0,1036,1048
115971,30,4,14,0,1036,1066
10752,26,1,14,0,1037,1063
48654,38,1,14,0,1037,1075
91745,32,2,14,0,1037,1069
106105,5,1,13,0,1037,1042
12157,25,1,14,1,1038,1063
27045,2,1,13,0,1038,1040
44886,115,5,16,1,1038,1153
67949,36,7,14,0,1038,1074
76690,2,1,13,0,1038,1040
110426,2,1,13,0,1038,1040
16595,6,6,13,1,1039,1045
19450,17,1,13,0,1039,1056
31170,28,1,14,0,1039,1067
32907,5,4,13,0,1039,1044
45605,32,1,14,0,1039,1071
51491,20,1,13,0,1039,1059
63401,5,3,13,0,1039,1044
127233,12,5,13,0,1039,1051
13004,7,1,13,0,1040,1047
13648,39,9,14,0,1040,1079
21562,33,2,14,0,1040,1073
36867,35,4,14,0,1040,1075
61440,20,3,14,0,1040,1060
73160,98,1,15,1,1040,1138
74783,15,2,13,1,1040,1055
93949,17,2,13,0,1040,1057
96513,29,1,14,1,1040,1069
97654,43,4,14,0,1040,1083
106928,3,2,13,0,1040,1043
120373,58,2,14,1,1040,1098
129672,5,4,13,1,1040,1045
21753,25,5,14,1,1041,1066
23135,22,2,14,0,1041,1063
34341,30,1,14,0,1041,1071
103668,9,2,13,0,1041,1050
108759,28,2,14,0,1041,1069
7026,27,2,14,0,1042,1069
7054,27,1,14,0,1042,1069
8506,24,1,14,0,1042,1066
16905,3,1,13,0,1042,1045
28532,39,3,14,1,1042,1081
28708,34,5,14,0,1042,1076
37156,60,2,15,0,1042,1102
48021,28,4,14,0,1042,1070
88423,21,2,14,0,1042,1063
112462,26,1,14,0,1042,1068
118380,24,2,14,0,1042,1066
126021,27,1,14,0,1042,1069
54043,20,1,14,0,1043,1063
69795,24,3,14,0,1043,1067
92993,36,3,14,1,1043,1079
97172,25,1,14,0,1043,1068
109213,5,1,13,0,1043,1048
113554,22,2,14,0,1043,1065
116196,9,1,13,1,1043,1052
8027,17,2,14,0,1044,1061
23521,34,1,14,1,1044,1078
41452,51,2,14,1,1044,1095
96467,33,3,14,1,1044,1077
101312,28,1,14,0,1044,1072
6677,21,1,14,0,1045,1066
11969,13,1,13,0,1045,1058
17385,16,4,14,0,1045,1061
35085,23,2,14,0,1045,1068
36813,16,3,14,0,1045,1061
40838,18,3,14,0,1045,1063
51878,21,1,14,0,1045,1066
53621,20,2,14,0,1045,1065
58985,4,1,13,0,1045,1049
77570,32,1,14,1,1045,1077
93078,21,1,14,0,1045,1066
99968,16,5,14,0,1045,1061
101237,20,1,14,0,1045,1065
110819,26,1,14,0,1045,1071
119557,18,1,14,0,1045,1063
121562,21,1,14,0,1045,1066
124714,23,2,14,0,1045,1068
129302,20,7,14,0,1045,1065
23228,5,3,13,0,1046,1051
43281,5,1,13,0,1046,1051
47010,5,1,13,0,1046,1051
78444,5,1,13,0,1046,1051
82320,23,2,14,0,1046,1069
82627,17,4,14,0,1046,1063
90596,12,3,13,0,1046,1058
93484,17,3,14,0,1046,1063
94750,22,4,14,0,1046,1068
95304,7,10,13,0,1046,1053
106178,20,2,14,0,1046,1066
112106,5,1,13,0,1046,1051
114032,5,1,13,0,1046,1051
115979,5,1,13,0,1046,1051
128948,5,1,13,0,1046,1051
18015,16,6,14,0,1047,1063
26791,30,2,14,0,1047,1077
31669,9,1,13,0,1047,1056
42488,8,1,13,1,1047,1055
60332,9,1,13,0,1047,1056
62166,16,1,14,0,1047,1063
76563,19,2,14,0,1047,1066
81589,19,2,14,0,1047,1066
91842,14,1,14,0,1047,1061
103605,75,8,15,0,1047,1122
112910,32,2,14,0,1047,1079
119609,19,3,14,0,1047,1066
123066,9,1,13,0,1047,1056
123136,16,2,14,0,1047,1063
129585,16,1,14,0,1047,1063
6302,9,2,13,0,1048,1057
7177,9,1,13,0,1048,1057
8595,15,5,14,0,1048,1063
10751,35,2,14,0,1048,1083
15160,7,1,13,0,1048,1055
17259,3,2,13,0,1048,1051
17836,7,1,13,0,1048,1055
19588,15,1,14,0,1048,1063
20761,3,1,13,0,1048,1051
21909,20,2,14,0,1048,1068
22578,15,1,14,0,1048,1063
27554,18,1,14,0,1048,1066
30471,16,2,14,0,1048,1064
30643,9,1,13,0,1048,1057
32753,15,3,14,0,1048,1063
35654,10,2,13,0,1048,1058
39310,22,2,14,0,1048,1070
44942,24,3,14,0,1048,1072
51880,3,5,13,0,1048,1051
53961,15,1,14,0,1048,1063
60117,15,1,14,0,1048,1063
60662,33,2,14,0,1048,1081
62493,3,2,13,0,1048,1051
63578,12,2,14,0,1048,1060
63812,12,1,14,0,1048,1060
67744,15,4,14,0,1048,1063
67806,16,2,14,0,1048,1064
70680,18,4,14,0,1048,1066
70866,15,1,14,0,1048,1063
70981,7,1,13,0,1048,1055
78604,3,2,13,0,1048,1051
80734,7,1,13,0,1048,1055
84502,7,1,13,0,1048,1055
84737,15,1,14,0,1048,1063
85814,3,2,13,0,1048,1051
89019,15,1,14,0,1048,1063
95070,33,2,14,0,1048,1081
96121,55,1,15,0,1048,1103
106007,30,1,14,0,1048,1078
107135,9,1,13,0,1048,1057
107634,15,1,14,0,1048,1063
111036,15,1,14,0,1048,1063
112398,9,1,13,0,1048,1057
112563,9,1,13,0,1048,1057
114480,27,3,14,1,1048,1075
116082,15,1,14,0,1048,1063
117034,7,1,13,0,1048,1055
117286,12,1,14,0,1048,1060
120089,15,1,14,0,1048,1063
122331,114,2,16,0,1048,1162
122713,18,3,14,0,1048,1066
124002,18,2,14,0,1048,1066
127614,18,2,14,0,1048,1066
129863,14,3,14,0,1048,1062
11893,10,1,13,0,1049,1059
31092,14,2,14,0,1049,1063
39238,6,1,13,0,1049,1055
47606,10,5,13,0,1049,1059
62511,14,4,14,0,1049,1063
73016,56,1,15,1,1049,1105
73053,14,7,14,0,1049,1063
74270,10,4,13,0,1049,1059
77628,45,5,14,1,1049,1094
80130,23,3,14,0,1049,1072
96501,15,2,14,0,1049,1064
106832,8,4,13,1,1049,1057
121288,10,5,13,0,1049,1059
11669,13,1,14,0,1050,1063
17976,22,1,14,1,1050,1072
27655,14,1,14,0,1050,1064
27665,8,2,13,0,1050,1058
29385,18,2,14,0,1050,1068
38916,13,1,14,0,1050,1063
39652,10,3,14,0,1050,1060
41252,9,5,13,0,1050,1059
56698,11,1,14,0,1050,1061
60651,6,6,13,1,1050,1056
66479,6,1,13,0,1050,1056
77998,7,1,13,0,1050,1057
84840,18,3,14,0,1050,1068
109467,15,2,14,0,1050,1065
112020,23,1,14,1,1050,1073
118291,60,2,15,0,1050,1110
120956,9,2,13,0,1050,1059
128717,14,1,14,0,1050,1064
13016,7,5,13,0,1051,1058
23004,13,1,14,0,1051,1064
24044,7,2,13,0,1051,1058
24137,14,6,14,0,1051,1065
33798,6,3,13,0,1051,1057
50574,158,2,17,0,1051,1209
52318,15,1,14,0,1051,1066
52989,21,2,14,0,1051,1072
59215,9,2,14,0,1051,1060
59801,15,1,14,0,1051,1066
63593,18,1,14,0,1051,1069
70400,11,4,14,0,1051,1062
73114,47,2,14,1,1051,1098
75733,20,1,14,0,1051,1071
79737,23,2,14,0,1051,1074
92351,12,2,14,0,1051,1063
94854,12,3,14,0,1051,1063
101210,9,2,14,0,1051,1060
101466,5,8,13,0,1051,1056
104285,4,3,13,0,1051,1055
105480,6,2,13,0,1051,1057
108398,4,3,13,0,1051,1055
111781,14,3,14,0,1051,1065
119707,12,2,14,0,1051,1063
123638,15,1,14,0,1051,1066
128491,8,4,13,0,1051,1059
129373,21,2,14,0,1051,1072
13347,6,3,13,0,1052,1058
16595,11,7,14,1,1052,1063
42172,3,2,13,0,1052,1055
88418,8,1,14,0,1052,1060
121071,24,1,14,0,1052,1076
38084,7,5,14,0,1053,1060
61516,12,1,14,0,1053,1065
68347,56,3,15,1,1053,1109
59028,6,4,14,0,1054,1060
78488,65,4,15,1,1054,1119
80592,12,2,14,0,1054,1066
95968,3,1,13,0,1054,1057
100803,3,1,13,0,1054,1057
101798,36,1,14,1,1054,1090
104612,43,3,14,1,1054,1097
20761,12,2,14,0,1055,1067
23228,12,4,14,0,1055,1067
26415,26,1,14,0,1055,1081
28318,3,5,13,0,1055,1058
32356,46,2,15,0,1055,1101
43281,12,2,14,0,1055,1067
45463,22,1,14,0,1055,1077
47010,12,2,14,0,1055,1067
50621,24,2,14,0,1055,1079
53474,16,1,14,0,1055,1071
69803,4,5,13,0,1055,1059
70578,17,1,14,0,1055,1072
70967,9,1,14,0,1055,1064
72640,17,1,14,0,1055,1072
78444,12,2,14,0,1055,1067
89422,9,1,14,0,1055,1064
103668,23,3,14,0,1055,1078
104415,24,2,14,0,1055,1079
106463,23,1,14,0,1055,1078
107349,11,1,14,0,1055,1066
112106,12,2,14,0,1055,1067
114032,12,2,14,0,1055,1067
115753,13,1,14,0,1055,1068
115979,12,2,14,0,1055,1067
128948,12,2,14,0,1055,1067
13004,10,2,14,0,1056,1066
43020,21,2,14,0,1056,1077
47096,16,1,14,0,1056,1072
57893,24,2,14,0,1056,1080
58123,7,1,14,0,1056,1063
80989,23,2,14,0,1056,1079
82629,7,1,14,0,1056,1063
91961,73,2,15,1,1056,1129
111663,13,1,14,0,1056,1069
112166,16,1,14,0,1056,1072
14606,19,4,14,0,1057,1076
18782,11,3,14,0,1057,1068
20684,20,1,14,0,1057,1077
21796,2,2,13,0,1057,1059
24333,10,2,14,0,1057,1067
40733,22,3,14,0,1057,1079
43347,134,5,17,0,1057,1191
43493,6,1,14,0,1057,1063
44787,31,2,14,0,1057,1088
52055,8,1,14,0,1057,1065
59394,21,3,14,0,1057,1078
61569,47,4,15,0,1057,1104
69666,13,6,14,1,1057,1070
73948,17,3,14,1,1057,1074
86766,11,4,14,0,1057,1068
89537,22,4,14,0,1057,1079
105310,23,2,14,0,1057,1080
109012,16,2,14,0,1057,1073
120716,14,5,14,0,1057,1071
121394,11,3,14,0,1057,1068
129672,14,5,14,1,1057,1071
17259,7,3,14,0,1058,1065
27045,14,2,14,0,1058,1072
36927,53,2,15,0,1058,1111
43520,7,3,14,0,1058,1065
51880,7,6,14,0,1058,1065
57564,18,1,14,0,1058,1076
58985,9,2,14,0,1058,1067
62365,5,10,14,0,1058,1063
64200,4,1,14,0,1058,1062
68180,7,10,14,0,1058,1065
71285,7,5,14,0,1058,1065
76690,14,2,14,0,1058,1072
79440,51,2,15,1,1058,1109
86209,65,1,15,1,1058,1123
98176,20,2,14,0,1058,1078
106988,7,1,14,0,1058,1065
110426,14,2,14,0,1058,1072
127233,7,6,14,0,1058,1065
5546,4,3,14,0,1059,1063
6302,11,3,14,0,1059,1070
7177,11,2,14,0,1059,1070
15160,11,2,14,0,1059,1070
16057,18,5,14,0,1059,1077
17836,11,2,14,0,1059,1070
21015,20,3,14,0,1059,1079
21836,14,2,14,0,1059,1073
29030,28,2,14,0,1059,1087
30643,11,2,14,0,1059,1070
37936,3,7,14,0,1059,1062
39238,11,2,14,0,1059,1070
39959,18,5,14,0,1059,1077
45262,3,1,14,0,1059,1062
49638,163,3,17,1,1059,1222
54081,18,5,14,0,1059,1077
58907,10,1,14,0,1059,1069
65765,19,1,14,0,1059,1078
68748,18,3,14,0,1059,1077
70981,11,2,14,0,1059,1070
73222,11,4,14,1,1059,1070
80734,11,2,14,0,1059,1070
84502,11,2,14,0,1059,1070
94814,35,1,14,0,1059,1094
97186,3,4,14,0,1059,1062
107135,11,2,14,0,1059,1070
107378,7,4,14,0,1059,1066
107582,3,4,14,0,1059,1062
109238,6,1,14,0,1059,1065
110228,14,1,14,0,1059,1073
112398,11,2,14,0,1059,1070
112563,11,2,14,0,1059,1070
115306,20,3,14,0,1059,1079
117034,11,2,14,0,1059,1070
118052,3,2,14,1,1059,1062
20898,8,3,14,0,1060,1068
24609,6,5,14,0,1060,1066
32381,10,1,14,0,1060,1070
37296,10,2,14,0,1060,1070
38541,10,1,14,0,1060,1070
43389,17,2,14,0,1060,1077
45055,18,3,14,0,1060,1078
48903,69,1,15,1,1060,1129
51167,10,1,14,0,1060,1070
53843,20,1,14,0,1060,1080
68781,10,2,14,0,1060,1070
77642,14,7,14,0,1060,1074
83380,10,1,14,0,1060,1070
90596,12,4,14,0,1060,1072
98575,9,5,14,0,1060,1069
109768,3,1,14,0,1060,1063
113298,27,1,14,0,1060,1087
114978,26,1,14,0,1060,1086
116729,3,3,14,0,1060,1063
117978,12,1,14,0,1060,1072
6398,22,2,14,0,1061,1083
16525,21,2,14,0,1061,1082
34210,130,3,17,0,1061,1191
54113,21,1,14,0,1061,1082
57358,29,1,14,0,1061,1090
65328,20,1,14,0,1061,1081
67360,147,3,17,0,1061,1208
71053,21,2,14,0,1061,1082
71302,10,2,14,0,1061,1071
76662,21,2,14,0,1061,1082
77512,10,1,14,0,1061,1071
84961,10,1,14,0,1061,1071
101210,2,3,14,0,1061,1063
114163,29,2,14,0,1061,1090
117172,20,1,14,0,1061,1081
16634,8,1,14,0,1062,1070
16905,4,2,14,0,1062,1066
19679,25,1,14,0,1062,1087
41144,8,1,14,0,1062,1070
42270,8,2,14,0,1062,1070
47774,14,1,14,0,1062,1076
51215,8,1,14,0,1062,1070
55894,5,2,14,0,1062,1067
59772,4,4,14,1,1062,1066
91314,45,2,15,0,1062,1107
94386,4,2,14,0,1062,1066
111022,8,1,14,0,1062,1070
111720,48,1,15,1,1062,1110
115915,4,2,14,0,1062,1066
124271,8,1,14,0,1062,1070
128356,14,1,14,0,1062,1076
128491,17,5,14,0,1062,1079
6062,3,2,14,0,1063,1066
11435,14,2,14,0,1063,1077
11893,22,2,14,0,1063,1085
13287,5,6,14,0,1063,1068
13418,5,3,14,0,1063,1068
14427,15,1,14,0,1063,1078
18441,16,1,14,0,1063,1079
19551,3,1,14,0,1063,1066
20603,16,3,14,0,1063,1079
24044,2,3,14,0,1063,1065
30817,4,4,14,0,1063,1067
34100,138,8,17,0,1063,1201
35522,20,1,14,0,1063,1083
38084,7,6,14,0,1063,1070
42172,2,3,14,0,1063,1065
49257,44,2,15,0,1063,1107
54051,7,2,14,0,1063,1070
54851,23,4,14,1,1063,1086
57644,16,1,14,0,1063,1079
57780,2,3,14,0,1063,1065
58052,4,1,14,0,1063,1067
59062,22,4,14,0,1063,1085
62537,23,2,14,0,1063,1086
69803,5,6,14,0,1063,1068
70126,3,5,14,0,1063,1066
70400,7,5,14,0,1063,1070
71343,3,2,14,0,1063,1066
71523,4,1,14,0,1063,1067
74587,23,2,14,0,1063,1086
78064,6,7,14,0,1063,1069
79333,2,2,14,0,1063,1065
80867,4,1,14,0,1063,1067
85183,25,7,14,0,1063,1088
87380,24,2,14,0,1063,1087
87645,3,3,14,0,1063,1066
88888,7,2,14,0,1063,1070
90841,8,3,14,0,1063,1071
91782,3,3,14,0,1063,1066
95045,3,2,14,0,1063,1066
100081,69,1,15,1,1063,1132
101486,3,5,14,0,1063,1066
104021,5,1,14,0,1063,1068
104285,4,4,14,0,1063,1067
106332,3,2,14,0,1063,1066
107760,12,3,14,0,1063,1075
108398,4,4,14,0,1063,1067
115627,13,1,14,0,1063,1076
117223,9,2,14,0,1063,1072
118637,3,5,14,0,1063,1066
118864,8,3,14,0,1063,1071
119263,93,3,16,0,1063,1156
123066,5,2,14,0,1063,1068
123504,13,2,14,0,1063,1076
123829,13,1,14,0,1063,1076
124225,3,1,14,0,1063,1066
126710,3,10,14,0,1063,1066
127266,3,2,14,0,1063,1066
127526,16,3,14,1,1063,1079
127796,3,1,14,0,1063,1066
129477,4,3,14,0,1063,1067
129748,2,8,14,0,1063,1065
7097,16,1,14,0,1064,1080
11488,4,3,14,0,1064,1068
17223,62,3,15,1,1064,1126
20245,2,2,14,0,1064,1066
31458,40,2,15,0,1064,1104
32308,15,1,14,0,1064,1079
38743,39,1,15,0,1064,1103
40413,16,1,14,0,1064,1080
48898,14,2,14,0,1064,1078
48964,23,4,14,0,1064,1087
61400,40,1,15,0,1064,1104
72579,26,1,14,0,1064,1090
76879,15,7,14,0,1064,1079
78131,31,3,14,0,1064,1095
94678,41,1,15,1,1064,1105
101829,61,1,15,0,1064,1125
103551,22,1,14,0,1064,1086
104831,11,5,14,0,1064,1075
109413,15,2,14,0,1064,1079
127469,2,8,14,1,1064,1066
13016,3,6,14,0,1065,1068
51532,25,1,14,0,1065,1090
53624,14,3,14,0,1065,1079
73882,14,3,14,0,1065,1079
82815,14,2,14,0,1065,1079
91160,25,1,14,0,1065,1090
105943,13,3,14,0,1065,1078
106307,10,4,14,0,1065,1075
117443,25,1,14,0,1065,1090
129037,16,1,14,0,1065,1081
13853,20,1,14,0,1066,1086
16783,20,1,14,0,1066,1086
20699,4,5,14,0,1066,1070
21121,13,2,14,0,1066,1079
28125,44,3,15,1,1066,1110
39782,14,4,14,0,1066,1080
46815,199,2,19,1,1066,1265
48818,121,2,17,0,1066,1187
51855,9,2,14,0,1066,1075
63536,28,1,14,0,1066,1094
65945,38,1,15,0,1066,1104
88833,13,2,14,0,1066,1079
90673,20,1,14,0,1066,1086
92542,17,1,14,0,1066,1083
95494,108,3,16,0,1066,1174
97229,17,1,14,0,1066,1083
105540,4,5,14,0,1066,1070
106369,6,4,14,0,1066,1072
107549,18,1,14,0,1066,1084
107894,14,3,14,0,1066,1080
118858,38,3,15,0,1066,1104
124836,20,1,14,0,1066,1086
125872,10,2,14,0,1066,1076
128027,2,2,14,0,1066,1068
20153,20,2,14,0,1067,1087
27665,19,3,14,0,1067,1086
30471,5,3,14,0,1067,1072
31604,8,7,14,0,1067,1075
33967,30,2,14,0,1067,1097
35564,38,1,15,1,1067,1105
39257,39,1,15,1,1067,1106
63837,14,5,14,1,1067,1081
78207,11,2,14,0,1067,1078
80788,7,9,14,0,1067,1074
112542,4,1,14,1,1067,1071
129748,17,9,14,0,1067,1084
10030,19,3,14,0,1068,1087
13123,11,2,14,0,1068,1079
16386,14,1,14,0,1068,1082
17115,36,3,15,0,1068,1104
39433,32,2,15,0,1068,1100
47007,18,1,14,0,1068,1086
50598,11,4,14,0,1068,1079
59251,16,2,14,0,1068,1084
71808,11,1,14,0,1068,1079
81795,35,2,15,0,1068,1103
90784,18,1,14,0,1068,1086
103311,16,6,14,0,1068,1084
111781,7,4,14,0,1068,1075
118787,11,1,14,0,1068,1079
125611,17,2,14,0,1068,1085
8258,11,1,14,0,1069,1080
11444,37,2,15,1,1069,1106
36167,56,3,15,1,1069,1125
51849,3,4,14,0,1069,1072
53337,35,1,15,0,1069,1104
74721,13,3,14,0,1069,1082
95941,11,4,14,0,1069,1080
98872,10,1,14,0,1069,1079
107390,16,1,14,1,1069,1085
113766,19,2,14,0,1069,1088
114048,57,8,15,1,1069,1126
123639,19,1,14,0,1069,1088
8821,9,2,14,0,1070,1079
14503,10,2,14,0,1070,1080
19856,18,2,14,0,1070,1088
24585,3,3,14,0,1070,1073
59028,2,5,14,0,1070,1072
64901,34,1,15,0,1070,1104
85995,9,5,14,0,1070,1079
92356,6,2,14,0,1070,1076
103106,9,1,14,0,1070,1079
108603,28,3,14,0,1070,1098
121993,9,1,14,1,1070,1079
127704,32,4,15,1,1070,1102
12687,4,8,14,0,1071,1075
12728,8,1,14,0,1071,1079
23322,8,2,14,0,1071,1079
29694,8,2,14,0,1071,1079
33497,14,1,14,0,1071,1085
43369,11,1,14,0,1071,1082
66631,39,5,15,0,1071,1110
68299,14,1,14,0,1071,1085
79443,10,4,14,0,1071,1081
87889,40,1,15,0,1071,1111
102669,12,1,14,0,1071,1083
15114,13,2,14,0,1072,1085
28318,6,6,14,0,1072,1078
46896,32,3,15,1,1072,1104
57738,37,3,15,0,1072,1109
65632,11,3,14,0,1072,1083
118716,14,4,14,0,1072,1086
6753,8,3,14,0,1073,1081
18253,10,3,14,0,1073,1083
22251,10,1,14,0,1073,1083
26624,10,1,14,0,1073,1083
27300,8,1,14,0,1073,1081
30293,8,1,14,0,1073,1081
33798,3,4,14,0,1073,1076
35944,10,1,14,0,1073,1083
39662,77,1,16,0,1073,1150
41538,10,1,14,0,1073,1083
48694,10,1,14,0,1073,1083
49083,10,1,14,0,1073,1083
52049,15,2,14,0,1073,1088
61673,10,1,14,0,1073,1083
72492,8,1,14,0,1073,1081
75008,10,1,14,0,1073,1083
94660,77,1,16,0,1073,1150
95610,3,1,14,0,1073,1076
105680,10,1,14,0,1073,1083
107555,26,1,14,0,1073,1099
107725,8,1,14,0,1073,1081
116411,3,2,14,0,1073,1076
120891,10,1,14,0,1073,1083
125405,13,2,14,0,1073,1086
128797,8,1,14,0,1073,1081
129672,8,6,14,0,1073,1081
17908,6,1,14,0,1074,1080
41252,20,6,14,0,1074,1094
41271,5,2,14,0,1074,1079
82658,6,1,14,0,1074,1080
11488,3,4,14,0,1075,1078
24137,4,7,14,1,1075,1079
33827,34,5,15,0,1075,1109
109041,26,2,15,0,1075,1101
111090,4,1,14,0,1075,1079
20247,34,1,15,0,1076,1110
22832,6,6,14,0,1076,1082
28898,36,1,15,0,1076,1112
53188,58,7,15,0,1076,1134
58876,71,1,16,0,1076,1147
69330,30,5,15,0,1076,1106
77547,33,2,15,0,1076,1109
78435,71,1,16,0,1076,1147
94744,12,4,14,0,1076,1088
129620,14,1,14,0,1076,1090
47054,33,3,15,0,1077,1110
60080,34,2,15,0,1077,1111
78554,39,9,15,1,1077,1116
87610,13,1,14,0,1077,1090
105657,5,3,14,1,1077,1082
113482,59,1,15,1,1077,1136
129069,2,4,14,0,1077,1079
10907,10,1,14,0,1078,1088
15135,9,1,14,0,1078,1087
33753,16,5,14,0,1078,1094
35425,9,1,14,0,1078,1087
47669,42,2,15,0,1078,1120
70144,12,4,14,0,1078,1090
90138,42,10,15,1,1078,1120
112710,10,2,14,0,1078,1088
120298,3,3,14,0,1078,1081
120942,10,2,14,0,1078,1088
121373,12,1,14,0,1078,1090
52989,24,3,15,0,1079,1103
54458,109,2,17,0,1079,1188
55727,59,3,15,1,1079,1138
74783,19,3,14,1,1079,1098
78740,25,2,15,0,1079,1104
86586,24,2,15,1,1079,1103
87341,8,4,14,0,1079,1087
104875,8,3,14,0,1079,1087
104882,21,1,15,0,1079,1100
105480,2,3,14,0,1079,1081
111830,8,3,14,0,1079,1087
125591,23,1,15,0,1079,1102
129125,29,2,15,1,1079,1108
129373,11,3,14,0,1079,1090
7261,7,6,14,0,1080,1087
10731,7,7,14,0,1080,1087
23135,14,3,14,0,1080,1094
27482,7,1,14,0,1080,1087
28426,7,4,14,0,1080,1087
30982,7,2,14,0,1080,1087
31946,23,2,15,0,1080,1103
38693,7,1,14,0,1080,1087
42130,24,3,15,0,1080,1104
43885,23,2,15,0,1080,1103
48242,20,2,15,0,1080,1100
50643,56,2,15,0,1080,1136
67220,13,2,14,0,1080,1093
73222,14,5,14,1,1080,1094
75738,111,3,17,0,1080,1191
84484,23,2,15,0,1080,1103
86166,26,1,15,0,1080,1106
86704,7,7,14,0,1080,1087
87259,7,2,14,0,1080,1087
92302,7,6,14,0,1080,1087
94854,19,4,14,0,1080,1099
105559,7,2,14,0,1080,1087
117248,19,2,14,0,1080,1099
118052,31,3,15,1,1080,1111
12697,2,4,14,1,1081,1083
51849,7,5,14,0,1081,1088
54709,6,3,14,0,1081,1087
57732,19,9,15,0,1081,1100
81738,11,3,14,1,1081,1092
25058,4,1,14,0,1082,1086
25672,18,3,15,0,1082,1100
37191,6,3,14,0,1082,1088
68731,6,3,14,0,1082,1088
70582,8,2,14,0,1082,1090
75612,73,1,16,1,1082,1155
102880,85,2,16,0,1082,1167
103668,4,4,14,0,1082,1086
104160,16,6,14,1,1082,1098
108808,24,5,15,0,1082,1106
115753,4,2,14,0,1082,1086
116472,16,1,14,1,1082,1098
126243,4,2,14,0,1082,1086
128027,4,3,14,0,1082,1086
12728,4,2,14,0,1083,1087
21336,7,4,14,0,1083,1090
32348,26,4,15,0,1083,1109
54099,20,3,15,1,1083,1103
61034,49,1,15,1,1083,1132
80788,5,10,14,0,1083,1088
93476,26,3,15,1,1083,1109
102152,3,3,14,0,1083,1086
106053,5,1,14,0,1083,1088
120911,7,2,14,0,1083,1090
121920,14,5,14,0,1083,1097
43463,26,1,15,1,1084,1110
56463,4,3,14,0,1084,1088
59772,13,5,14,1,1084,1097
61440,13,4,14,0,1084,1097
75116,20,1,15,0,1084,1104
79872,20,2,15,1,1084,1104
88534,19,4,15,1,1084,1103
107100,64,1,16,0,1084,1148
120716,14,6,14,0,1084,1098
129037,10,2,14,0,1084,1094
12148,17,1,15,1,1085,1102
14699,35,1,15,0,1085,1120
14711,29,4,15,0,1085,1114
24120,12,1,14,0,1085,1097
24210,10,2,14,0,1085,1095
25025,79,3,16,0,1085,1164
26288,10,2,14,1,1085,1095
28806,72,1,16,1,1085,1157
40413,9,2,14,0,1085,1094
50621,10,3,14,0,1085,1095
70705,15,2,15,1,1085,1100
81540,12,1,14,0,1085,1097
100425,12,1,14,0,1085,1097
104415,10,3,14,0,1085,1095
118011,15,1,15,0,1085,1100
119260,12,2,14,0,1085,1097
120525,12,1,14,0,1085,1097
122638,12,2,14,0,1085,1097
125314,12,1,14,0,1085,1097
125767,24,1,15,1,1085,1109
127469,10,9,14,1,1085,1095
11488,8,5,14,0,1086,1094
21448,23,1,15,1,1086,1109
28258,8,1,14,0,1086,1094
28708,8,6,14,0,1086,1094
36761,12,3,14,0,1086,1098
69264,40,1,15,1,1086,1126
74203,14,1,15,0,1086,1100
111090,9,2,14,0,1086,1095
115490,38,5,15,0,1086,1124
122516,8,6,14,0,1086,1094
124620,8,6,14,0,1086,1094
125988,45,2,15,1,1086,1131
41460,18,1,15,1,1087,1105
47089,8,7,14,0,1087,1095
50229,5,2,14,0,1087,1092
75733,50,2,15,0,1087,1137
84126,8,3,14,0,1087,1095
97654,13,5,15,0,1087,1100
109087,12,2,14,0,1087,1099
13648,7,10,14,0,1088,1095
16905,6,3,14,0,1088,1094
18416,3,2,14,0,1088,1091
21015,6,4,14,0,1088,1094
21392,6,1,14,0,1088,1094
30630,6,1,14,0,1088,1094
50598,14,5,15,0,1088,1102
51179,6,2,14,0,1088,1094
56485,6,1,14,0,1088,1094
68922,6,2,14,0,1088,1094
71808,6,2,14,0,1088,1094
72979,6,1,14,0,1088,1094
74721,21,4,15,0,1088,1109
81910,6,2,14,0,1088,1094
82831,6,4,14,1,1088,1094
88866,6,1,14,0,1088,1094
91994,31,1,15,1,1088,1119
94105,5,2,14,0,1088,1093
94612,11,1,14,1,1088,1099
100601,6,3,14,0,1088,1094
105943,6,4,14,0,1088,1094
107922,20,1,15,0,1088,1108
109413,6,3,14,0,1088,1094
113069,6,1,14,0,1088,1094
125486,6,1,14,0,1088,1094
126710,5,11,14,0,1088,1093
129069,11,5,14,0,1088,1099
129869,6,1,14,0,1088,1094
16151,5,2,14,0,1089,1094
22779,4,1,14,0,1089,1093
31648,4,2,14,0,1089,1093
48294,4,2,14,0,1089,1093
52142,4,1,14,0,1089,1093
62785,4,4,14,0,1089,1093
65232,4,6,14,0,1089,1093
67806,7,3,14,0,1089,1096
69023,4,4,14,0,1089,1093
78207,4,3,14,0,1089,1093
86635,29,1,15,1,1089,1118
111510,4,2,14,0,1089,1093
117156,6,3,14,0,1089,1095
121562,6,2,14,0,1089,1095
126801,15,1,15,1,1089,1104
127796,3,2,14,0,1089,1092
7515,2,2,14,0,1090,1092
20245,35,3,15,0,1090,1125
63242,21,2,15,1,1090,1111
83063,94,5,17,0,1090,1184
113422,90,2,17,1,1090,1180
39782,9,5,15,0,1091,1100
62853,75,1,16,0,1091,1166
105165,3,2,14,1,1091,1094
106832,43,5,15,1,1092,1135
46756,69,1,16,0,1094,1163
51849,40,6,15,0,1094,1134
63555,21,1,15,1,1094,1115
112539,40,1,15,1,1094,1134
119405,33,1,15,0,1094,1127
14503,69,3,16,0,1095,1164
27482,91,2,17,0,1095,1186
52049,28,3,15,0,1095,1123
65632,5,4,15,0,1095,1100
80788,7,11,15,0,1095,1102
121993,25,2,15,1,1095,1120
123639,8,2,15,0,1095,1103
10731,14,8,15,0,1096,1110
21639,81,4,16,1,1096,1177
59596,68,3,16,0,1096,1164
85995,5,6,15,0,1096,1101
11893,7,3,15,0,1097,1104
86704,10,8,15,0,1097,1107
92302,12,7,15,0,1097,1109
101798,10,2,15,1,1097,1107
105165,17,3,15,1,1097,1114
128816,35,3,15,1,1097,1132
13648,11,11,15,0,1099,1110
42556,33,1,15,1,1099,1132
44787,23,3,15,0,1099,1122
114824,8,1,15,0,1099,1107
22832,9,7,15,0,1100,1109
80501,92,1,17,0,1100,1192
106053,105,2,17,0,1100,1205
9460,48,10,16,0,1101,1149
24137,3,8,15,1,1101,1104
33753,8,6,15,0,1101,1109
78131,8,4,15,0,1101,1109
81383,23,4,15,1,1101,1124
86766,9,5,15,0,1101,1110
127469,16,10,15,1,1101,1117
13347,85,4,17,0,1102,1187
16718,22,1,15,0,1102,1124
77628,154,6,18,1,1102,1256
94744,81,5,17,0,1102,1183
95561,19,1,15,0,1102,1121
10030,19,4,15,0,1103,1122
32707,70,3,16,0,1103,1173
7261,10,7,15,0,1104,1114
11488,11,6,15,0,1104,1115
12697,2,5,15,1,1104,1106
28426,8,5,15,0,1104,1112
116904,15,1,15,0,1104,1119
53089,68,1,16,0,1105,1173
57437,58,1,16,0,1105,1163
95662,5,4,15,0,1105,1110
13728,14,4,15,0,1106,1120
16408,41,6,16,0,1106,1147
17908,19,2,15,0,1106,1125
18118,10,5,15,0,1106,1116
31655,96,3,17,0,1106,1202
44621,85,2,17,0,1106,1191
47844,84,1,17,0,1106,1190
59772,4,6,15,1,1106,1110
59802,106,1,17,0,1106,1212
61761,38,1,16,1,1106,1144
74016,85,1,17,0,1106,1191
92424,18,4,15,0,1106,1124
107725,17,2,15,0,1106,1123
108196,18,1,15,0,1106,1124
111367,80,1,17,0,1106,1186
112542,5,2,15,1,1106,1111
120298,6,4,15,0,1106,1112
21336,19,5,15,0,1107,1126
23656,83,1,17,0,1107,1190
36550,12,1,15,0,1107,1119
45605,74,2,17,0,1107,1181
60831,83,2,17,0,1107,1190
76096,83,1,17,0,1107,1190
77789,21,1,15,1,1107,1128
83393,83,5,17,0,1107,1190
87225,19,1,15,0,1107,1126
88534,19,5,15,1,1107,1126
94320,85,1,17,0,1107,1192
100838,83,4,17,0,1107,1190
105465,84,1,17,0,1107,1191
109467,13,3,15,0,1107,1120
8595,4,6,15,0,1108,1112
35977,4,8,15,1,1108,1112
42291,14,1,15,0,1108,1122
50598,4,6,15,0,1108,1112
51532,16,2,15,0,1108,1124
65196,93,3,17,0,1108,1201
69666,4,7,15,1,1108,1112
82180,42,2,16,0,1108,1150
89630,14,1,15,0,1108,1122
99677,42,3,16,0,1108,1150
126855,95,2,17,0,1108,1203
19442,41,4,16,0,1109,1150
20170,13,1,15,0,1109,1122
21015,55,5,16,0,1109,1164
27196,13,4,15,0,1109,1122
28708,15,7,15,0,1109,1124
36622,13,2,15,0,1109,1122
39234,11,2,15,0,1109,1120
39782,13,6,15,0,1109,1122
39818,13,1,15,0,1109,1122
40859,77,1,17,0,1109,1186
44396,77,1,17,0,1109,1186
55966,77,1,17,0,1109,1186
56645,12,1,15,0,1109,1121
59798,74,1,17,0,1109,1183
63041,14,2,15,0,1109,1123
67509,15,1,15,0,1109,1124
67744,10,5,15,0,1109,1119
73354,78,1,17,0,1109,1187
76165,77,1,17,0,1109,1186
80788,13,12,15,0,1109,1122
80795,14,1,15,0,1109,1123
80989,79,3,17,0,1109,1188
82034,12,2,15,0,1109,1121
82173,13,1,15,0,1109,1122
85579,78,1,17,0,1109,1187
100745,7,1,15,0,1109,1116
102062,81,1,17,0,1109,1190
105825,13,1,15,0,1109,1122
113643,13,1,15,0,1109,1122
115347,9,4,15,0,1109,1118
115581,77,1,17,0,1109,1186
116912,77,1,17,0,1109,1186
116933,77,1,17,0,1109,1186
117087,36,1,16,0,1109,1145
118551,13,3,15,0,1109,1122
122067,81,1,17,0,1109,1190
124143,77,1,17,0,1109,1186
127284,77,1,17,0,1109,1186
129069,11,6,15,0,1109,1120
7565,79,1,17,0,1110,1189
15187,77,1,17,0,1110,1187
15198,77,1,17,0,1110,1187
16905,13,4,15,0,1110,1123
17740,77,1,17,0,1110,1187
17982,77,1,17,0,1110,1187
20551,74,1,17,0,1110,1184
27363,74,1,17,0,1110,1184
29986,46,2,16,0,1110,1156
32165,38,7,16,0,1110,1148
32786,77,1,17,0,1110,1187
34796,73,1,17,0,1110,1183
36285,10,1,15,0,1110,1120
38688,11,2,15,1,1110,1121
38693,11,2,15,0,1110,1121
41198,12,2,15,0,1110,1122
42285,77,1,17,0,1110,1187
43109,20,2,15,0,1110,1130
44745,77,1,17,0,1110,1187
49253,54,1,16,0,1110,1164
50353,77,1,17,0,1110,1187
55305,10,1,15,0,1110,1120
55734,77,1,17,0,1110,1187
68343,77,2,17,0,1110,1187
69028,77,1,17,0,1110,1187
72866,74,1,17,0,1110,1184
76951,79,1,17,0,1110,1189
77659,74,1,17,0,1110,1184
82200,44,1,16,0,1110,1154
83426,74,1,17,0,1110,1184
83794,14,1,15,0,1110,1124
85756,5,6,15,0,1110,1115
85995,52,7,16,0,1110,1162
86262,77,1,17,0,1110,1187
86400,55,2,16,0,1110,1165
86669,77,1,17,0,1110,1187
86704,12,9,15,0,1110,1122
86970,74,1,17,0,1110,1184
88418,85,2,17,0,1110,1195
88436,77,4,17,0,1110,1187
88992,11,1,15,0,1110,1121
92648,74,1,17,0,1110,1184
94909,9,1,15,0,1110,1119
101988,14,1,15,0,1110,1124
105752,73,7,17,0,1110,1183
106673,74,1,17,0,1110,1184
107809,73,1,17,0,1110,1183
111830,21,4,15,0,1110,1131
115169,77,1,17,0,1110,1187
116447,9,1,15,0,1110,1119
117030,77,1,17,0,1110,1187
118291,9,3,15,0,1110,1119
118380,10,3,15,0,1110,1120
118848,77,1,17,0,1110,1187
120832,77,3,17,0,1110,1187
121484,70,2,17,0,1110,1180
128443,13,2,15,0,1110,1123
128684,11,1,15,0,1110,1121
28151,76,1,17,0,1111,1187
29694,3,3,15,0,1111,1114
37156,13,3,15,0,1111,1124
37960,73,3,17,0,1111,1184
48242,10,3,15,0,1111,1121
54081,8,6,15,0,1111,1119
57358,11,2,15,0,1111,1122
68731,13,4,15,0,1111,1124
86299,10,2,15,0,1111,1121
90784,11,2,15,0,1111,1122
91566,10,2,15,0,1111,1121
93795,76,1,17,0,1111,1187
94678,7,2,15,1,1111,1118
107390,12,2,15,1,1111,1123
109944,70,1,17,0,1111,1181
112462,40,2,16,0,1111,1151
20898,10,4,15,0,1112,1122
33967,8,3,15,0,1112,1120
37750,10,3,15,0,1112,1122
39866,76,2,17,1,1112,1188
47007,7,2,15,0,1112,1119
54709,7,4,15,0,1112,1119
62627,7,1,15,0,1112,1119
80130,5,4,15,0,1112,1117
100776,7,1,15,0,1112,1119
104875,35,4,16,0,1112,1147
105559,7,3,15,0,1112,1119
106007,12,2,15,0,1112,1124
111781,36,5,16,0,1112,1148
112710,10,3,15,0,1112,1122
119068,37,1,16,0,1112,1149
123639,68,3,17,0,1112,1180
7551,34,2,16,0,1113,1147
35085,8,3,15,0,1113,1121
53843,7,2,15,0,1113,1120
67785,16,1,15,0,1113,1129
79333,103,3,17,0,1113,1216
94612,3,2,15,1,1113,1116
106808,74,3,17,1,1113,1187
113887,88,2,17,0,1113,1201
124714,8,3,15,0,1113,1121
24137,9,9,15,0,1114,1123
26503,73,1,17,0,1114,1187
27907,73,1,17,0,1114,1187
31957,7,3,15,0,1114,1121
34981,7,3,15,0,1114,1121
38916,13,2,15,0,1114,1127
59772,16,7,15,1,1114,1130
67376,18,2,15,0,1114,1132
83415,33,4,16,0,1114,1147
90292,49,2,16,0,1114,1163
98216,5,2,15,0,1114,1119
125191,73,1,17,0,1114,1187
128186,50,1,16,0,1114,1164
41452,72,3,17,1,1115,1187
71089,6,1,15,0,1115,1121
82831,12,5,15,1,1115,1127
95662,33,5,16,0,1115,1148
114480,37,4,16,1,1115,1152
124152,47,3,16,1,1115,1162
23521,62,2,16,1,1116,1178
58780,50,1,16,0,1116,1166
78740,12,3,15,0,1116,1128
92302,3,8,15,0,1116,1119
120298,4,5,15,0,1116,1120
5969,33,1,16,0,1117,1150
48022,50,1,16,0,1117,1167
64902,50,1,16,0,1117,1167
86565,52,1,16,0,1117,1169
97884,52,1,16,0,1117,1169
108063,50,1,16,0,1117,1167
111720,55,2,16,1,1117,1172
126438,53,1,16,1,1117,1170
7547,31,1,16,0,1118,1149
19129,48,1,16,0,1118,1166
52895,47,1,16,0,1118,1165
55165,33,4,16,0,1118,1151
66196,33,1,16,0,1118,1151
73454,82,4,17,0,1118,1200
94612,10,3,15,1,1118,1128
104612,60,4,16,1,1118,1178
120286,15,1,15,0,1118,1133
120359,48,1,16,0,1118,1166
20015,46,1,16,0,1119,1165
23928,48,1,16,0,1119,1167
29124,66,1,17,0,1119,1185
30318,123,1,18,0,1119,1242
32632,48,1,16,0,1119,1167
36674,31,1,16,0,1119,1150
37191,68,4,17,0,1119,1187
38739,46,1,16,0,1119,1165
40073,33,2,16,0,1119,1152
44096,46,1,16,0,1119,1165
47161,46,1,16,0,1119,1165
62173,67,1,17,0,1119,1186
72411,28,2,16,0,1119,1147
74110,65,1,17,0,1119,1184
74820,72,1,17,0,1119,1191
76921,46,1,16,0,1119,1165
77570,145,2,19,1,1119,1264
80924,67,1,17,0,1119,1186
94093,20,1,15,0,1119,1139
101715,46,1,16,0,1119,1165
105294,33,1,16,0,1119,1152
105318,46,1,16,0,1119,1165
117994,46,1,16,0,1119,1165
125942,20,1,15,0,1119,1139
126370,123,1,18,0,1119,1242
5506,46,1,16,0,1120,1166
6929,43,1,16,0,1120,1163
13287,13,7,15,0,1120,1133
14561,131,1,18,0,1120,1251
20081,7,1,15,0,1120,1127
22832,37,8,16,0,1120,1157
23304,2,1,15,0,1120,1122
25058,46,2,16,0,1120,1166
25483,2,1,15,0,1120,1122
27223,71,1,17,0,1120,1191
29527,43,2,16,0,1120,1163
33827,58,6,16,0,1120,1178
38084,46,7,16,0,1120,1166
41149,46,1,16,0,1120,1166
41532,45,1,16,0,1120,1165
48898,49,3,16,0,1120,1169
51492,46,1,16,0,1120,1166
52553,46,1,16,0,1120,1166
56064,27,3,16,0,1120,1147
56463,69,4,17,0,1120,1189
58649,43,2,16,0,1120,1163
60619,46,1,16,0,1120,1166
60816,120,2,18,0,1120,1240
61569,44,5,16,0,1120,1164
62785,29,5,16,0,1120,1149
63784,46,2,16,0,1120,1166
64875,46,1,16,0,1120,1166
65464,46,1,16,0,1120,1166
65632,46,5,16,0,1120,1166
66369,46,1,16,0,1120,1166
66479,72,2,17,0,1120,1192
67980,14,1,15,0,1120,1134
70400,2,6,15,0,1120,1122
74783,43,4,16,0,1120,1163
76576,46,1,16,0,1120,1166
76929,106,1,18,0,1120,1226
78667,123,1,18,0,1120,1243
79629,46,1,16,0,1120,1166
81474,29,4,16,0,1120,1149
84279,85,2,17,0,1120,1205
86137,31,6,16,0,1120,1151
87703,46,1,16,0,1120,1166
87757,46,1,16,0,1120,1166
87889,36,2,16,0,1120,1156
93125,46,1,16,0,1120,1166
95501,13,1,15,0,1120,1133
96140,45,1,16,0,1120,1165
106260,68,1,17,0,1120,1188
106463,43,2,16,0,1120,1163
107719,45,1,16,0,1120,1165
107998,46,1,16,0,1120,1166
108159,68,3,17,0,1120,1188
109116,46,2,16,0,1120,1166
111474,46,1,16,0,1120,1166
111549,46,1,16,0,1120,1166
112898,46,1,16,0,1120,1166
116047,46,1,16,0,1120,1166
117823,46,2,16,0,1120,1166
120963,46,1,16,0,1120,1166
122349,46,1,16,0,1120,1166
123630,46,1,16,0,1120,1166
125360,43,1,16,0,1120,1163
127413,51,1,16,0,1120,1171
129321,43,2,16,0,1120,1163
129746,46,1,16,0,1120,1166
7261,79,8,17,0,1121,1200
11728,51,1,16,0,1121,1172
12784,65,2,17,0,1121,1186
17976,51,2,16,1,1121,1172
24690,41,1,16,0,1121,1162
24933,62,1,17,0,1121,1183
29229,3,3,15,0,1121,1124
29694,64,4,17,0,1121,1185
30817,11,5,15,0,1121,1132
47054,59,4,17,0,1121,1180
50283,38,1,16,0,1121,1159
50598,73,7,17,0,1121,1194
60780,45,1,16,0,1121,1166
76662,31,3,16,0,1121,1152
86586,8,3,15,0,1121,1129
91314,45,3,16,0,1121,1166
94346,2,3,15,0,1121,1123
101135,51,1,16,1,1121,1172
103311,68,7,17,0,1121,1189
105801,60,1,17,0,1121,1181
120525,69,2,17,0,1121,1190
121071,45,2,16,0,1121,1166
121316,45,1,16,0,1121,1166
121858,67,1,17,0,1121,1188
124965,39,1,16,0,1121,1160
6686,11,4,15,0,1122,1133
7043,40,1,16,0,1122,1162
7515,73,3,17,0,1122,1195
8690,40,1,16,0,1122,1162
10148,40,1,16,0,1122,1162
10654,40,1,16,0,1122,1162
10731,58,9,17,0,1122,1180
11893,38,4,16,0,1122,1160
12571,47,1,16,0,1122,1169
12788,27,1,16,0,1122,1149
13620,27,3,16,0,1122,1149
14471,77,4,17,0,1122,1199
14573,40,1,16,0,1122,1162
18591,40,1,16,0,1122,1162
20818,41,1,16,0,1122,1163
21406,40,1,16,0,1122,1162
21756,12,1,15,0,1122,1134
23322,63,3,17,0,1122,1185
23699,40,5,16,0,1122,1162
26607,51,1,16,0,1122,1173
26987,75,5,17,0,1122,1197
27408,39,1,16,0,1122,1161
28024,40,1,16,0,1122,1162
28426,13,6,15,0,1122,1135
28890,46,1,16,0,1122,1168
28898,61,2,17,0,1122,1183
29042,40,1,16,0,1122,1162
29361,40,1,16,0,1122,1162
29816,40,1,16,0,1122,1162
35579,40,1,16,0,1122,1162
36777,40,1,16,0,1122,1162
36927,43,3,16,0,1122,1165
38211,40,1,16,0,1122,1162
39074,40,1,16,0,1122,1162
39453,9,3,15,0,1122,1131
39560,75,9,17,0,1122,1197
40035,41,1,16,0,1122,1163
40736,40,1,16,0,1122,1162
45536,40,1,16,0,1122,1162
45852,28,1,16,0,1122,1150
46560,40,1,16,0,1122,1162
49986,58,5,17,0,1122,1180
50220,40,1,16,0,1122,1162
50891,82,1,17,0,1122,1204
51778,2,1,15,0,1122,1124
52519,77,4,17,0,1122,1199
52520,75,7,17,0,1122,1197
54051,39,3,16,0,1122,1161
55237,77,5,17,0,1122,1199
55334,40,1,16,0,1122,1162
56119,28,1,16,0,1122,1150
58720,12,1,15,0,1122,1134
59148,43,1,16,0,1122,1165
59759,41,2,16,0,1122,1163
62365,75,11,17,0,1122,1197
62772,40,1,16,0,1122,1162
64637,12,1,15,0,1122,1134
64682,40,1,16,0,1122,1162
65087,40,1,16,0,1122,1162
67434,82,2,17,0,1122,1204
67948,41,1,16,0,1122,1163
68399,25,6,16,0,1122,1147
68479,40,1,16,0,1122,1162
69743,75,6,17,0,1122,1197
72316,41,1,16,0,1122,1163
72665,40,1,16,0,1122,1162
73053,58,8,17,0,1122,1180
77395,40,1,16,0,1122,1162
79093,39,1,16,0,1122,1161
79864,39,1,16,0,1122,1161
81354,52,3,16,0,1122,1174
82061,48,1,16,0,1122,1170
82143,49,1,16,0,1122,1171
85756,9,7,15,0,1122,1131
86962,12,1,15,0,1122,1134
91261,40,1,16,0,1122,1162
92492,40,1,16,0,1122,1162
96309,40,1,16,0,1122,1162
97525,46,1,16,0,1122,1168
98064,52,1,16,0,1122,1174
100121,40,1,16,0,1122,1162
100140,40,1,16,0,1122,1162
100502,40,1,16,0,1122,1162
103668,25,5,16,0,1122,1147
105068,40,1,16,0,1122,1162
108089,25,1,16,0,1122,1147
110992,75,4,17,0,1122,1197
111452,77,4,17,0,1122,1199
112916,40,1,16,0,1122,1162
116276,40,1,16,0,1122,1162
117150,72,1,17,0,1122,1194
118631,72,2,17,0,1122,1194
119799,8,2,15,0,1122,1130
119804,47,1,16,0,1122,1169
120944,47,1,16,0,1122,1169
123468,47,1,16,0,1122,1169
123586,40,1,16,0,1122,1162
124635,40,1,16,0,1122,1162
125200,50,3,16,0,1122,1172
125264,47,1,16,0,1122,1169
7242,40,1,16,0,1123,1163
7444,7,6,15,0,1123,1130
8143,40,1,16,0,1123,1163
8434,40,1,16,0,1123,1163
8587,40,1,16,0,1123,1163
8821,26,3,16,0,1123,1149
9202,25,2,16,0,1123,1148
9732,57,1,17,0,1123,1180
10440,40,1,16,0,1123,1163
11185,40,1,16,0,1123,1163
11970,40,1,16,0,1123,1163
12277,40,2,16,0,1123,1163
12408,10,1,15,0,1123,1133
13123,40,3,16,0,1123,1163
13246,40,1,16,0,1123,1163
13302,25,2,16,0,1123,1148
14985,40,1,16,0,1123,1163
15577,65,1,17,0,1123,1188
15985,54,1,16,0,1123,1177
16531,23,1,16,0,1123,1146
17584,40,1,16,0,1123,1163
18385,40,1,16,0,1123,1163
18456,40,1,16,0,1123,1163
19096,56,2,16,0,1123,1179
21121,55,3,16,0,1123,1178
21204,40,1,16,0,1123,1163
21314,40,1,16,0,1123,1163
22137,22,3,16,0,1123,1145
24189,40,1,16,0,1123,1163
24291,44,1,16,0,1123,1167
24333,40,3,16,0,1123,1163
25463,10,4,15,0,1123,1133
25590,40,1,16,0,1123,1163
26056,40,1,16,0,1123,1163
26146,25,2,16,0,1123,1148
26791,62,3,17,0,1123,1185
27018,40,1,16,0,1123,1163
27971,21,5,16,0,1123,1144
29704,23,1,16,0,1123,1146
30092,40,1,16,0,1123,1163
30451,40,2,16,0,1123,1163
30484,40,1,16,0,1123,1163
30629,40,1,16,0,1123,1163
31026,64,2,17,0,1123,1187
31615,40,1,16,0,1123,1163
31958,42,1,16,0,1123,1165
32086,40,5,16,0,1123,1163
32411,40,1,16,0,1123,1163
33568,40,1,16,0,1123,1163
33698,31,2,16,0,1123,1154
34271,40,1,16,0,1123,1163
35425,40,2,16,0,1123,1163
35665,44,1,16,0,1123,1167
35902,40,1,16,0,1123,1163
36681,40,1,16,0,1123,1163
36889,40,1,16,0,1123,1163
37503,40,1,16,0,1123,1163
37936,9,8,15,0,1123,1132
38842,40,1,16,0,1123,1163
40298,41,2,16,0,1123,1164
40507,40,1,16,0,1123,1163
41271,7,3,15,0,1123,1130
41439,40,1,16,0,1123,1163
41882,40,1,16,0,1123,1163
42340,40,1,16,0,1123,1163
43811,40,2,16,0,1123,1163
44195,40,1,16,0,1123,1163
44976,40,1,16,0,1123,1163
45162,23,2,16,0,1123,1146
45463,40,2,16,0,1123,1163
45868,40,1,16,0,1123,1163
46290,25,2,16,0,1123,1148
47801,39,1,16,0,1123,1162
48020,40,1,16,0,1123,1163
50117,40,3,16,0,1123,1163
50215,45,1,16,0,1123,1168
51200,40,1,16,0,1123,1163
53104,40,1,16,0,1123,1163
54683,45,1,16,0,1123,1168
55689,40,1,16,0,1123,1163
55910,40,1,16,0,1123,1163
56122,40,1,16,0,1123,1163
56767,40,1,16,0,1123,1163
57746,40,1,16,0,1123,1163
58811,55,1,16,0,1123,1178
58837,40,1,16,0,1123,1163
59049,40,1,16,0,1123,1163
59254,7,6,15,0,1123,1130
59358,40,1,16,0,1123,1163
60973,40,1,16,0,1123,1163
61199,40,3,16,0,1123,1163
61688,40,2,16,0,1123,1163
63516,40,1,16,0,1123,1163
63785,40,1,16,0,1123,1163
63812,40,2,16,0,1123,1163
63940,40,1,16,0,1123,1163
64901,46,2,16,0,1123,1169
65218,39,1,16,0,1123,1162
67686,40,1,16,0,1123,1163
68164,40,1,16,0,1123,1163
69129,40,1,16,0,1123,1163
70301,40,1,16,0,1123,1163
71083,55,1,16,0,1123,1178
71572,23,1,16,0,1123,1146
72232,40,1,16,0,1123,1163
73894,40,1,16,0,1123,1163
74089,44,1,16,0,1123,1167
74721,49,5,16,0,1123,1172
75491,42,1,16,0,1123,1165
76360,39,1,16,0,1123,1162
76948,40,1,16,0,1123,1163
77547,56,3,16,0,1123,1179
77635,40,1,16,0,1123,1163
78381,63,1,17,0,1123,1186
78545,40,1,16,0,1123,1163
79289,40,1,16,0,1123,1163
79921,40,1,16,0,1123,1163
80754,40,1,16,0,1123,1163
81795,40,3,16,0,1123,1163
82226,40,1,16,0,1123,1163
82377,40,1,16,0,1123,1163
82608,40,1,16,0,1123,1163
84897,40,1,16,0,1123,1163
86418,40,1,16,0,1123,1163
92400,25,4,16,0,1123,1148
94295,46,3,16,0,1123,1169
97281,46,1,16,0,1123,1169
99458,40,1,16,0,1123,1163
99773,40,1,16,0,1123,1163
100988,40,1,16,0,1123,1163
101239,46,1,16,0,1123,1169
101528,40,1,16,0,1123,1163
101602,40,1,16,0,1123,1163
102053,23,1,16,0,1123,1146
102093,40,1,16,0,1123,1163
102133,40,1,16,0,1123,1163
102152,24,4,16,0,1123,1147
102924,40,1,16,0,1123,1163
103443,42,1,16,0,1123,1165
105809,40,1,16,0,1123,1163
106124,40,1,16,0,1123,1163
106307,40,5,16,0,1123,1163
106423,40,2,16,0,1123,1163
106842,40,1,16,0,1123,1163
107728,40,2,16,0,1123,1163
107922,27,2,16,0,1123,1150
108557,40,1,16,0,1123,1163
108916,40,1,16,0,1123,1163
110858,40,1,16,0,1123,1163
111199,41,1,16,0,1123,1164
112444,40,1,16,0,1123,1163
112505,46,1,16,0,1123,1169
113021,40,1,16,0,1123,1163
113290,52,1,16,0,1123,1175
114824,40,2,16,0,1123,1163
115827,40,1,16,0,1123,1163
115993,23,1,16,0,1123,1146
116535,54,1,16,0,1123,1177
116645,40,1,16,0,1123,1163
116904,40,2,16,0,1123,1163
117070,3,4,15,0,1123,1126
117694,65,1,17,0,1123,1188
118477,23,1,16,0,1123,1146
119820,40,3,16,0,1123,1163
120187,40,2,16,0,1123,1163
120199,40,1,16,0,1123,1163
120647,40,1,16,0,1123,1163
120820,40,1,16,0,1123,1163
120956,38,3,16,0,1123,1161
121108,40,1,16,0,1123,1163
123563,40,1,16,0,1123,1163
123618,40,1,16,0,1123,1163
123983,40,1,16,0,1123,1163
125049,40,3,16,0,1123,1163
125221,40,1,16,0,1123,1163
125567,40,1,16,0,1123,1163
125648,40,1,16,0,1123,1163
125840,54,1,16,0,1123,1177
128714,40,1,16,0,1123,1163
129748,9,10,15,0,1123,1132
12200,39,3,16,0,1124,1163
15782,6,1,15,0,1124,1130
24210,39,3,16,0,1124,1163
27716,53,2,16,0,1124,1177
32503,5,1,15,0,1124,1129
49257,59,3,17,0,1124,1183
50621,61,4,17,0,1124,1185
65803,65,4,17,0,1124,1189
68503,39,2,16,0,1124,1163
72640,39,2,16,0,1124,1163
76879,47,8,16,0,1124,1171
77682,5,1,15,0,1124,1129
79440,76,3,17,1,1124,1200
90351,39,1,16,0,1124,1163
93723,65,3,17,0,1124,1189
97654,59,6,17,0,1124,1183
104037,40,1,16,0,1124,1164
104415,61,4,17,0,1124,1185
104465,51,1,16,0,1124,1175
104632,5,1,15,0,1124,1129
105890,54,1,16,0,1124,1178
111090,65,3,17,0,1124,1189
112020,46,2,16,1,1124,1170
113708,39,1,16,0,1124,1163
115306,25,4,16,0,1124,1149
118011,67,2,17,0,1124,1191
126710,25,12,16,0,1124,1149
9791,75,7,17,0,1125,1200
18747,50,1,16,1,1125,1175
31166,152,1,19,1,1125,1277
38743,61,2,17,0,1125,1186
39352,38,3,16,0,1125,1163
39433,6,3,15,0,1125,1131
47096,38,2,16,0,1125,1163
49724,66,2,17,1,1125,1191
57732,43,10,16,0,1125,1168
75783,38,1,16,0,1125,1163
79727,39,1,16,0,1125,1164
82476,38,3,16,0,1125,1163
105657,5,4,15,1,1125,1130
109087,38,3,16,0,1125,1163
112166,38,2,16,0,1125,1163
116196,47,2,16,1,1125,1172
118053,4,5,15,0,1125,1129
118858,47,4,16,0,1125,1172
32635,2,1,15,0,1126,1128
37311,2,1,15,0,1126,1128
41104,2,1,15,0,1126,1128
94678,40,3,16,1,1126,1166
95941,5,5,15,0,1126,1131
103519,39,1,16,0,1126,1165
109041,64,3,17,0,1126,1190
11444,7,3,15,1,1127,1134
29900,36,2,16,0,1127,1163
32308,61,2,17,0,1127,1188
40413,61,3,17,0,1127,1188
61400,36,2,16,0,1127,1163
73848,59,1,17,1,1127,1186
90688,56,1,17,0,1127,1183
91994,38,2,16,1,1127,1165
94386,20,3,16,0,1127,1147
104882,40,2,16,0,1127,1167
105480,55,4,17,0,1127,1182
111399,60,3,17,0,1127,1187
111510,59,3,17,0,1127,1186
129037,38,3,16,0,1127,1165
129383,54,2,17,0,1127,1181
25672,62,4,17,0,1128,1190
71808,8,3,15,0,1128,1136
78131,3,5,15,0,1128,1131
122155,18,1,16,0,1128,1146
129300,28,1,16,1,1128,1156
29312,19,1,16,0,1129,1148
42130,50,4,16,0,1129,1179
51778,5,2,15,0,1129,1134
57738,108,4,18,0,1129,1237
88136,37,3,16,0,1129,1166
95610,18,2,16,0,1129,1147
101798,2,3,15,1,1129,1131
116969,68,4,17,0,1129,1197
119061,21,6,16,0,1129,1150
129672,74,7,17,1,1129,1203
20245,21,4,16,0,1130,1151
25772,50,5,17,0,1130,1180
29229,33,4,16,0,1130,1163
35977,11,9,16,1,1130,1141
38688,94,3,17,1,1130,1224
65858,28,1,16,1,1130,1158
70307,33,2,16,0,1130,1163
70322,138,1,19,1,1130,1268
97036,52,4,17,0,1130,1182
118864,33,4,16,0,1130,1163
16595,16,8,16,1,1131,1147
21765,32,2,16,0,1131,1163
42488,38,2,16,1,1131,1169
87380,15,3,16,0,1131,1146
98405,18,6,16,1,1131,1149
106967,65,4,17,0,1131,1196
107886,16,1,16,0,1131,1147
19060,40,1,16,1,1132,1172
45003,11,1,16,0,1132,1143
73369,73,3,17,0,1132,1205
121222,21,7,16,0,1132,1153
12398,71,1,17,1,1133,1204
30817,14,6,16,0,1133,1147
51061,18,1,16,0,1133,1151
73114,4,3,15,1,1133,1137
89537,11,5,16,0,1133,1144
107555,29,2,16,0,1133,1162
112829,14,8,16,0,1133,1147
26315,22,4,16,1,1134,1156
81379,113,1,18,1,1134,1247
91704,29,2,16,0,1134,1163
113298,63,2,17,0,1134,1197
23188,48,6,17,0,1135,1183
29030,30,3,16,0,1135,1165
96467,28,4,16,0,1135,1163
17908,50,3,17,0,1136,1186
67509,51,2,17,0,1136,1187
90784,50,3,17,0,1136,1186
125749,19,5,16,1,1136,1155
11444,49,4,17,1,1137,1186
53324,16,1,16,0,1137,1153
28426,62,7,17,0,1138,1200
50752,45,6,17,0,1138,1183
71328,14,2,16,0,1138,1152
129748,6,11,16,0,1138,1144
11518,8,1,16,1,1139,1147
82034,49,3,17,0,1139,1188
107390,2,3,16,1,1139,1141
118551,17,4,16,0,1139,1156
12697,6,6,16,1,1140,1146
60665,23,3,16,0,1140,1163
103037,46,1,17,1,1140,1186
33967,60,4,17,0,1141,1201
80788,8,13,16,0,1141,1149
81383,31,5,16,1,1141,1172
84274,42,5,17,0,1141,1183
92939,34,1,16,1,1141,1175
101798,6,4,16,1,1141,1147
108808,7,6,16,0,1141,1148
6686,57,5,17,0,1142,1199
36823,41,4,17,0,1142,1183
53188,63,8,17,0,1142,1205
67376,50,3,17,0,1142,1192
79959,43,2,17,0,1142,1185
104160,4,7,16,1,1142,1146
121849,7,9,16,0,1142,1149
11488,4,7,16,0,1143,1147
13287,39,8,17,0,1143,1182
24137,20,10,16,0,1143,1163
25463,56,5,17,0,1143,1199
50275,45,1,17,0,1143,1188
9127,44,4,17,0,1144,1188
13019,39,7,17,0,1144,1183
21336,25,6,16,0,1144,1169
37936,19,9,16,0,1144,1163
41271,22,4,16,0,1144,1166
67785,68,2,17,0,1144,1212
70582,24,3,16,0,1144,1168
85756,5,8,16,0,1144,1149
101829,57,2,17,0,1144,1201
105107,44,4,17,1,1144,1188
116127,32,1,16,1,1144,1176
20170,38,2,17,0,1145,1183
21837,30,5,16,1,1145,1175
33753,16,7,16,0,1145,1161
36622,38,3,17,0,1145,1183
43369,23,2,16,0,1145,1168
67254,22,1,16,0,1145,1167
82173,38,2,17,0,1145,1183
84126,22,4,16,0,1145,1167
105825,38,2,17,0,1145,1183
106659,41,1,17,1,1145,1186
106665,22,7,16,0,1145,1167
113643,38,2,17,0,1145,1183
124493,20,1,16,0,1145,1165
127469,6,11,16,1,1145,1151
12408,17,2,16,0,1146,1163
13728,37,5,17,0,1146,1183
20163,34,5,17,0,1146,1180
37156,37,4,17,0,1146,1183
42291,40,2,17,0,1146,1186
50643,34,3,17,0,1146,1180
51532,45,3,17,0,1146,1191
52624,34,2,17,0,1146,1180
53253,37,4,17,0,1146,1183
53843,45,3,17,0,1146,1191
57358,3,3,16,0,1146,1149
61440,20,5,16,0,1146,1166
71053,28,3,16,0,1146,1174
85183,40,8,17,0,1146,1186
86699,37,4,17,0,1146,1183
87225,108,2,18,0,1146,1254
88992,38,2,17,0,1146,1184
89630,40,2,17,0,1146,1186
99087,17,1,16,0,1146,1163
109450,34,4,17,0,1146,1180
115141,79,6,18,0,1146,1225
118380,46,4,17,0,1146,1192
7444,36,7,17,0,1147,1183
9059,33,7,17,0,1147,1180
15782,15,2,16,0,1147,1162
17915,33,6,17,0,1147,1180
20247,36,2,17,0,1147,1183
28708,16,8,16,0,1147,1163
29099,19,1,16,0,1147,1166
35588,33,6,17,0,1147,1180
39433,16,4,16,0,1147,1163
49884,32,3,16,0,1147,1179
56860,33,6,17,0,1147,1180
59254,18,7,16,0,1147,1165
62918,50,7,17,0,1147,1197
63041,20,3,16,0,1147,1167
67759,15,4,16,1,1147,1162
68180,33,11,17,0,1147,1180
69997,33,6,17,0,1147,1180
71573,33,7,17,0,1147,1180
76409,33,6,17,0,1147,1180
78131,16,6,16,0,1147,1163
78740,28,4,16,0,1147,1175
80795,40,2,17,0,1147,1187
83147,33,8,17,0,1147,1180
91573,52,4,17,0,1147,1199
95345,52,3,17,0,1147,1199
103624,32,4,16,0,1147,1179
109856,57,5,17,0,1147,1204
110839,18,2,16,0,1147,1165
117309,18,4,16,0,1147,1165
118924,35,1,17,0,1147,1182
119799,59,3,17,0,1147,1206
126620,52,3,17,0,1147,1199
129748,33,12,17,0,1147,1180
15605,15,1,16,0,1148,1163
16151,15,3,16,0,1148,1163
20898,16,5,16,0,1148,1164
22905,14,1,16,0,1148,1162
25646,16,3,16,1,1148,1164
31946,18,3,16,0,1148,1166
36167,63,4,17,1,1148,1211
36761,15,4,16,0,1148,1163
37964,14,1,16,0,1148,1162
39782,25,7,16,0,1148,1173
39818,39,2,17,0,1148,1187
42472,14,1,16,0,1148,1162
43885,18,3,16,0,1148,1166
48242,57,4,17,0,1148,1205
50679,15,4,16,0,1148,1163
52989,19,4,16,0,1148,1167
56645,39,2,17,0,1148,1187
67220,31,3,16,0,1148,1179
67744,6,6,16,0,1148,1154
77834,15,2,16,0,1148,1163
79675,31,5,16,0,1148,1179
81210,14,1,16,0,1148,1162
81923,15,1,16,0,1148,1163
84484,18,3,16,0,1148,1166
85726,47,3,17,0,1148,1195
87259,21,3,16,0,1148,1169
94105,15,3,16,0,1148,1163
94854,31,5,16,0,1148,1179
97172,15,2,16,0,1148,1163
106047,14,1,16,0,1148,1162
106071,32,8,17,0,1148,1180
109221,14,1,16,0,1148,1162
109757,15,1,16,0,1148,1163
114482,14,2,16,0,1148,1162
117248,31,3,16,0,1148,1179
118053,39,6,17,0,1148,1187
120603,14,1,16,0,1148,1162
128027,15,4,16,0,1148,1163
129697,14,1,16,0,1148,1162
10030,15,5,16,0,1149,1164
11118,14,1,16,0,1149,1163
12233,14,1,16,0,1149,1163
13280,19,3,16,0,1149,1168
14418,23,1,16,0,1149,1172
14480,32,1,17,0,1149,1181
18021,32,2,17,0,1149,1181
18739,14,3,16,0,1149,1163
19551,31,2,17,0,1149,1180
22280,14,1,16,0,1149,1163
24585,111,4,19,0,1149,1260
25465,14,1,16,0,1149,1163
26145,49,3,17,0,1149,1198
30982,16,3,16,0,1149,1165
31458,14,3,16,0,1149,1163
32887,14,3,16,0,1149,1163
35085,28,4,16,0,1149,1177
38693,56,3,17,0,1149,1205
39234,51,3,17,0,1149,1200
40094,47,1,17,0,1149,1196
45505,34,1,17,0,1149,1183
47007,34,3,17,0,1149,1183
47916,15,2,16,0,1149,1164
48903,25,2,16,1,1149,1174
52142,14,2,16,0,1149,1163
53474,14,2,16,0,1149,1163
54448,14,1,16,0,1149,1163
54709,16,5,16,0,1149,1165
55305,76,2,18,0,1149,1225
56915,14,1,16,0,1149,1163
57391,14,2,16,0,1149,1163
61646,14,1,16,0,1149,1163
62627,15,2,16,0,1149,1164
63833,22,2,16,0,1149,1171
66208,14,1,16,0,1149,1163
70578,14,2,16,0,1149,1163
73009,46,3,17,0,1149,1195
74270,14,5,16,0,1149,1163
76454,14,2,16,0,1149,1163
77036,14,1,16,0,1149,1163
77642,14,8,16,0,1149,1163
78064,5,8,16,0,1149,1154
78207,30,4,16,0,1149,1179
78817,14,1,16,0,1149,1163
79209,8,1,16,0,1149,1157
84073,32,2,17,0,1149,1181
86299,49,3,17,0,1149,1198
86793,50,3,17,0,1149,1199
91160,15,2,16,0,1149,1164
91557,15,5,16,0,1149,1164
91566,49,3,17,0,1149,1198
93210,14,1,16,0,1149,1163
93829,34,2,17,0,1149,1183
94971,14,1,16,0,1149,1163
95073,14,1,16,0,1149,1163
99851,14,2,16,0,1149,1163
99968,58,6,17,0,1149,1207
101350,40,3,17,0,1149,1189
104400,14,2,16,0,1149,1163
105943,24,5,16,0,1149,1173
107760,50,4,17,0,1149,1199
111514,30,3,16,1,1149,1179
114006,37,1,17,0,1149,1186
115347,31,5,17,0,1149,1180
116447,34,2,17,0,1149,1183
117960,14,1,16,0,1149,1163
118369,30,1,16,0,1149,1179
120872,14,2,16,0,1149,1163
124620,14,7,16,0,1149,1163
124714,28,4,16,0,1149,1177
124951,34,2,17,0,1149,1183
127526,15,4,16,1,1149,1164
127682,14,1,16,0,1149,1163
128370,34,2,17,0,1149,1183
128491,39,6,17,0,1149,1188
128684,38,2,17,0,1149,1187
14753,6,1,16,1,1150,1156
31648,12,3,16,0,1150,1162
35524,14,1,16,0,1150,1164
66327,31,1,17,0,1150,1181
95941,10,6,16,0,1150,1160
108808,19,7,16,0,1150,1169
19442,15,5,16,0,1151,1166
27971,30,6,17,0,1151,1181
128959,12,1,16,0,1151,1163
129237,12,1,16,0,1151,1163
80867,10,2,16,0,1152,1162
108168,47,1,17,0,1152,1199
9721,6,3,16,0,1153,1159
81738,9,4,16,1,1153,1162
86635,6,2,16,1,1153,1159
107349,8,2,16,0,1153,1161
11916,12,1,16,0,1154,1166
28818,12,1,16,0,1154,1166
35787,12,1,16,0,1154,1166
43463,24,2,16,1,1154,1178
106920,12,1,16,0,1154,1166
44886,16,6,16,1,1155,1171
117920,39,1,17,0,1155,1194
5546,8,4,16,0,1156,1164
10645,8,1,16,0,1156,1164
13016,8,7,16,0,1156,1164
16660,8,2,16,0,1156,1164
17074,8,1,16,0,1156,1164
23023,8,1,16,0,1156,1164
23524,8,4,16,0,1156,1164
31170,8,2,16,0,1156,1164
35593,8,1,16,0,1156,1164
36210,32,1,17,1,1156,1188
48227,8,1,16,0,1156,1164
55899,31,10,17,1,1156,1187
72148,8,4,16,0,1156,1164
72153,8,1,16,0,1156,1164
98216,8,3,16,0,1156,1164
98575,8,6,16,0,1156,1164
103731,8,3,16,0,1156,1164
122560,8,1,16,0,1156,1164
124017,25,1,17,1,1156,1181
124984,8,2,16,0,1156,1164
129169,25,1,17,1,1156,1181
129869,8,2,16,0,1156,1164
13587,4,6,16,0,1157,1161
110700,20,1,16,1,1158,1178
29444,23,2,17,1,1159,1182
39712,29,3,17,1,1159,1188
72260,23,1,17,0,1159,1182
111805,23,1,17,0,1159,1182
129373,21,4,17,0,1159,1180
6807,21,1,17,0,1160,1181
22832,26,9,17,0,1160,1186
24120,24,2,17,0,1160,1184
45003,27,2,17,0,1160,1187
65265,21,1,17,0,1160,1181
81540,24,2,17,0,1160,1184
100425,24,2,17,0,1160,1184
112453,24,3,17,0,1160,1184
119061,24,7,17,0,1160,1184
119260,24,3,17,0,1160,1184
125314,24,2,17,0,1160,1184
15850,19,1,17,0,1161,1180
22483,19,1,17,0,1161,1180
22747,19,1,17,0,1161,1180
30299,19,1,17,0,1161,1180
37750,88,4,18,0,1161,1249
47475,19,4,17,0,1161,1180
48241,19,1,17,0,1161,1180
51061,54,2,17,0,1161,1215
51575,19,2,17,0,1161,1180
51740,19,1,17,0,1161,1180
56879,19,1,17,0,1161,1180
57146,19,1,17,0,1161,1180
58720,19,2,17,0,1161,1180
62608,39,1,17,0,1161,1200
68619,19,1,17,0,1161,1180
87610,47,2,17,0,1161,1208
94346,13,4,16,0,1161,1174
99779,19,1,17,0,1161,1180
100421,19,1,17,0,1161,1180
106711,19,1,17,0,1161,1180
112462,82,3,18,0,1161,1243
112683,11,1,16,0,1161,1172
113883,19,2,17,0,1161,1180
115024,23,2,17,0,1161,1184
119461,19,1,17,0,1161,1180
122638,23,3,17,0,1161,1184
122859,19,1,17,0,1161,1180
124174,19,2,17,0,1161,1180
13762,25,3,17,0,1162,1187
20245,52,5,17,0,1162,1214
23822,53,1,17,0,1162,1215
25483,2,2,16,0,1162,1164
27408,18,2,17,0,1162,1180
54051,18,4,17,0,1162,1180
69091,32,2,17,0,1162,1194
100081,20,2,17,1,1162,1182
103668,4,6,16,0,1162,1166
107894,22,4,17,0,1162,1184
126240,18,4,17,0,1162,1180
8821,22,4,17,0,1163,1185
29312,87,2,18,0,1163,1250
33698,3,3,16,0,1163,1166
52049,24,4,17,0,1163,1187
53852,34,1,17,0,1163,1197
57358,20,4,17,0,1163,1183
62785,3,6,16,0,1163,1166
81474,3,5,16,0,1163,1166
82404,78,1,18,0,1163,1241
87073,43,1,17,0,1163,1206
91961,35,3,17,1,1163,1198
95610,9,3,16,0,1163,1172
100745,21,2,17,0,1163,1184
102152,16,5,16,0,1163,1179
107725,25,3,17,0,1163,1188
112539,14,2,16,1,1163,1177
117070,2,5,16,0,1163,1165
117087,20,2,17,0,1163,1183
6083,13,1,16,0,1164,1177
6905,13,1,16,0,1164,1177
7835,13,1,16,0,1164,1177
8197,13,1,16,0,1164,1177
8871,13,1,16,0,1164,1177
9637,13,1,16,0,1164,1177
11488,34,8,17,0,1164,1198
13236,13,1,16,0,1164,1177
13418,13,4,16,0,1164,1177
14668,13,2,16,0,1164,1177
17046,13,1,16,0,1164,1177
20593,67,2,18,0,1164,1231
21392,16,2,17,0,1164,1180
22454,13,2,16,0,1164,1177
22822,13,1,16,0,1164,1177
24072,13,1,16,0,1164,1177
27196,45,5,17,0,1164,1209
28275,13,1,16,0,1164,1177
29379,13,1,16,0,1164,1177
29966,13,1,16,0,1164,1177
29986,23,3,17,0,1164,1187
30630,16,2,17,0,1164,1180
30773,13,2,16,0,1164,1177
31625,13,1,16,0,1164,1177
35525,13,1,16,0,1164,1177
36140,13,1,16,0,1164,1177
36505,13,1,16,0,1164,1177
38701,13,3,16,0,1164,1177
39959,16,6,17,0,1164,1180
41609,13,1,16,0,1164,1177
41762,13,1,16,0,1164,1177
43336,13,1,16,0,1164,1177
46333,13,1,16,0,1164,1177
47993,13,1,16,0,1164,1177
48825,13,1,16,0,1164,1177
48940,13,1,16,0,1164,1177
49532,13,1,16,0,1164,1177
49955,13,1,16,0,1164,1177
51179,16,3,17,0,1164,1180
52873,42,1,17,0,1164,1206
55244,13,1,16,0,1164,1177
55333,13,1,16,0,1164,1177
56485,16,2,17,0,1164,1180
57166,13,1,16,0,1164,1177
57501,13,1,16,0,1164,1177
58251,13,1,16,0,1164,1177
58633,13,1,16,0,1164,1177
62354,13,1,16,0,1164,1177
62761,13,1,16,0,1164,1177
62775,13,1,16,0,1164,1177
65131,13,3,16,0,1164,1177
65833,12,1,16,0,1164,1176
66438,13,1,16,0,1164,1177
68922,16,3,17,0,1164,1180
70723,13,1,16,0,1164,1177
71089,96,2,19,0,1164,1260
71928,13,1,16,0,1164,1177
71944,13,1,16,0,1164,1177
72979,16,2,17,0,1164,1180
75198,13,1,16,0,1164,1177
77049,13,2,16,0,1164,1177
77101,13,1,16,0,1164,1177
78488,43,5,17,1,1164,1207
79590,16,7,17,0,1164,1180
81293,13,1,16,0,1164,1177
82311,13,1,16,0,1164,1177
82837,13,1,16,0,1164,1177
83738,13,1,16,0,1164,1177
84502,13,3,16,0,1164,1177
85259,13,1,16,0,1164,1177
85305,13,1,16,0,1164,1177
87617,13,1,16,0,1164,1177
87889,2,3,16,0,1164,1166
88616,13,1,16,0,1164,1177
88866,16,2,17,0,1164,1180
89743,13,1,16,0,1164,1177
91554,13,1,16,0,1164,1177
92492,13,2,16,0,1164,1177
95304,8,11,16,0,1164,1172
95980,13,1,16,0,1164,1177
96086,16,6,17,0,1164,1180
98152,13,1,16,0,1164,1177
99216,16,7,17,0,1164,1180
100121,13,2,16,0,1164,1177
100601,16,4,17,0,1164,1180
102315,13,1,16,0,1164,1177
105068,13,2,16,0,1164,1177
108812,13,1,16,0,1164,1177
108841,13,2,16,0,1164,1177
109235,13,1,16,0,1164,1177
109958,13,1,16,0,1164,1177
111085,13,1,16,0,1164,1177
111167,22,1,17,0,1164,1186
112762,13,1,16,0,1164,1177
113069,16,2,17,0,1164,1180
113318,13,2,16,0,1164,1177
113435,13,1,16,0,1164,1177
115789,13,1,16,0,1164,1177
117339,13,2,16,0,1164,1177
118052,20,4,17,1,1164,1184
118551,16,5,17,0,1164,1180
118698,13,1,16,0,1164,1177
119263,11,4,16,0,1164,1175
121012,17,1,17,0,1164,1181
121967,13,1,16,0,1164,1177
123448,13,1,16,0,1164,1177
124205,13,1,16,0,1164,1177
124276,13,1,16,0,1164,1177
125287,13,1,16,0,1164,1177
125303,13,1,16,0,1164,1177
125486,16,2,17,0,1164,1180
126345,13,1,16,0,1164,1177
126428,13,2,16,0,1164,1177
129534,13,1,16,0,1164,1177
129869,16,3,17,0,1164,1180
14711,6,5,16,0,1165,1171
18510,47,1,17,0,1165,1212
18561,18,2,17,0,1165,1183
26053,47,1,17,0,1165,1212
33568,45,2,17,0,1165,1210
40080,47,1,17,0,1165,1212
43491,36,4,17,0,1165,1201
50117,15,4,17,0,1165,1180
51855,47,3,17,0,1165,1212
52288,6,13,16,0,1165,1171
56064,14,4,16,0,1165,1179
58522,14,4,16,0,1165,1179
59215,17,3,17,0,1165,1182
65765,36,2,17,0,1165,1201
72411,19,3,17,0,1165,1184
72772,23,1,17,0,1165,1188
73824,47,2,17,0,1165,1212
85213,47,1,17,0,1165,1212
88774,47,1,17,0,1165,1212
88833,21,3,17,0,1165,1186
91889,36,4,17,0,1165,1201
95658,14,6,16,0,1165,1179
96172,47,1,17,0,1165,1212
100591,47,1,17,0,1165,1212
100865,47,1,17,0,1165,1212
109467,21,4,17,0,1165,1186
115827,10,2,16,0,1165,1175
124202,10,1,16,0,1165,1175
129786,10,1,16,0,1165,1175
23304,3,2,16,0,1166,1169
25712,10,1,16,0,1166,1176
26215,14,1,17,1,1166,1180
33909,58,2,17,0,1166,1224
36285,23,2,17,0,1166,1189
47669,3,3,16,0,1166,1169
52977,26,1,17,0,1166,1192
63242,9,3,16,0,1166,1175
67744,33,7,17,0,1166,1199
68327,49,2,17,0,1166,1215
68731,6,5,16,0,1166,1172
82200,24,2,17,0,1166,1190
90138,15,11,17,1,1166,1181
92424,36,5,17,0,1166,1202
103267,9,1,16,0,1166,1175
103865,21,1,17,0,1166,1187
119068,32,2,17,0,1166,1198
124647,9,1,16,0,1166,1175
125688,17,1,17,0,1166,1183
35579,90,2,18,0,1167,1257
43493,111,2,19,0,1167,1278
73797,59,1,18,0,1167,1226
76563,44,3,17,0,1167,1211
82629,111,2,19,0,1167,1278
86847,10,1,16,0,1167,1177
89435,10,1,16,0,1167,1177
94909,5,2,16,0,1167,1172
111036,10,2,16,0,1167,1177
115490,8,6,16,0,1167,1175
126367,10,1,16,0,1167,1177
128122,20,2,17,0,1167,1187
5596,19,7,17,0,1168,1187
14699,63,2,18,0,1168,1231
16718,10,2,16,0,1168,1178
23004,110,2,19,0,1168,1278
37499,12,5,17,0,1168,1180
48843,66,1,18,0,1168,1234
52314,60,1,18,0,1168,1228
98575,15,7,17,0,1168,1183
109122,8,1,16,0,1168,1176
111712,10,2,16,0,1168,1178
119609,34,4,17,0,1168,1202
19270,88,1,18,0,1169,1257
76662,17,4,17,0,1169,1186
79443,15,5,17,0,1169,1184
12157,30,2,17,0,1170,1200
20115,42,2,17,0,1170,1212
36368,25,3,17,1,1170,1195
49175,5,3,16,0,1170,1175
57564,13,2,17,0,1170,1183
69204,31,2,17,0,1170,1201
79209,7,2,16,0,1170,1177
109184,14,1,17,0,1170,1184
120302,64,1,18,0,1170,1234
7774,55,1,18,0,1171,1226
40939,10,6,17,0,1171,1181
58985,10,3,17,0,1171,1181
75491,17,2,17,0,1171,1188
103443,17,2,17,0,1171,1188
106832,13,6,17,1,1171,1184
109397,28,1,17,0,1171,1199
111199,17,2,17,0,1171,1188
117745,62,1,18,0,1171,1233
8147,9,1,17,0,1172,1181
28250,9,1,17,0,1172,1181
29479,9,2,17,0,1172,1181
59254,6,8,16,0,1172,1178
87222,9,1,17,0,1172,1181
96228,9,1,17,0,1172,1181
102670,54,1,18,0,1172,1226
112829,8,9,17,0,1172,1180
6669,6,1,16,0,1173,1179
23866,8,1,17,0,1173,1181
26265,7,4,17,0,1173,1180
27554,55,2,18,0,1173,1228
31789,76,2,18,0,1173,1249
42605,15,1,17,0,1173,1188
44886,23,7,17,1,1173,1196
50613,16,1,17,0,1173,1189
51200,8,2,17,0,1173,1181
93936,3,1,16,0,1173,1176
104037,5,2,16,0,1173,1178
106665,5,8,16,0,1173,1178
129037,13,4,17,0,1173,1186
8320,5,1,16,0,1174,1179
29422,3,7,16,0,1174,1177
45852,10,2,17,0,1174,1184
57780,12,4,17,0,1174,1186
59772,13,8,17,1,1174,1187
72148,51,5,18,0,1174,1225
84452,3,7,16,0,1174,1177
99332,6,3,17,0,1174,1180
17752,50,2,18,0,1175,1225
29030,13,4,17,0,1175,1188
29871,12,1,17,0,1175,1187
37824,25,3,17,0,1175,1200
58780,12,2,17,0,1175,1187
70582,23,4,17,0,1175,1198
85863,17,1,17,0,1175,1192
111663,5,2,17,0,1175,1180
9202,6,3,17,0,1176,1182
9334,2,1,16,0,1176,1178
46896,25,4,17,1,1176,1201
58123,102,2,19,0,1176,1278
59148,9,2,17,0,1176,1185
67686,51,2,18,0,1176,1227
73653,49,1,18,0,1176,1225
116196,6,3,17,1,1176,1182
125749,15,6,17,1,1176,1191
19442,19,6,17,0,1177,1196
49253,7,2,17,0,1177,1184
53621,11,3,17,0,1177,1188
55702,21,1,17,0,1177,1198
61569,11,6,17,0,1177,1188
61761,24,2,17,1,1177,1201
62828,13,1,17,0,1177,1190
70301,10,2,17,0,1177,1187
90468,66,1,18,0,1177,1243
92869,23,3,17,0,1177,1200
98872,3,2,17,0,1177,1180
112542,20,3,17,1,1177,1197
112910,14,3,17,0,1177,1191
119858,13,1,17,0,1177,1190
128186,8,2,17,0,1177,1185
129792,53,1,18,0,1177,1230
21796,10,3,17,0,1178,1188
25483,5,3,17,0,1178,1183
60780,5,2,17,0,1178,1183
60973,5,2,17,0,1178,1183
67980,78,2,18,0,1178,1256
87380,4,4,17,0,1178,1182
98263,43,1,17,0,1178,1221
121316,5,2,17,0,1178,1183
25646,27,4,17,1,1179,1206
28532,45,4,17,1,1179,1224
39782,30,8,17,0,1179,1209
48654,9,2,17,0,1179,1188
66996,17,3,17,0,1179,1196
93476,72,4,18,1,1179,1251
100962,9,1,17,0,1179,1188
105657,5,5,17,1,1179,1184
112020,82,3,19,1,1179,1261
125887,21,2,17,0,1179,1200
16408,10,7,17,0,1180,1190
24137,18,11,17,0,1180,1198
33753,20,8,17,0,1180,1200
38192,9,3,17,0,1180,1189
39448,3,11,17,0,1180,1183
47669,18,4,17,0,1180,1198
52288,4,14,17,0,1180,1184
55906,74,1,18,0,1180,1254
67869,25,3,17,0,1180,1205
71808,8,4,17,0,1180,1188
86400,22,3,17,0,1180,1202
86704,10,10,17,0,1180,1190
95941,4,7,17,0,1180,1184
108808,20,8,17,0,1180,1200
109122,55,2,18,0,1180,1235
124388,27,3,17,0,1180,1207
127469,24,12,17,1,1180,1204
129507,74,1,18,0,1180,1254
14418,2,2,17,0,1181,1183
18015,18,7,17,0,1181,1199
18409,5,3,17,1,1181,1186
32635,74,2,18,0,1181,1255
37311,74,2,18,0,1181,1255
41104,2,2,17,0,1181,1183
41532,74,2,18,0,1181,1255
47916,5,3,17,0,1181,1186
55962,96,1,19,0,1181,1277
59596,4,4,17,0,1181,1185
64200,97,2,19,0,1181,1278
86635,14,3,17,1,1181,1195
92993,42,4,17,1,1181,1223
95465,74,1,18,0,1181,1255
95501,74,2,18,0,1181,1255
95791,6,3,17,0,1181,1187
96140,74,2,18,0,1181,1255
101277,5,1,17,1,1181,1186
107719,74,2,18,0,1181,1255
107922,24,3,17,0,1181,1205
125200,83,4,19,1,1181,1264
11094,23,3,17,0,1182,1205
13144,29,4,17,0,1182,1211
46370,43,1,18,0,1182,1225
58052,8,2,17,0,1182,1190
64397,47,1,18,0,1182,1229
78740,20,5,17,0,1182,1202
84230,60,1,18,0,1182,1242
93673,6,2,17,0,1182,1188
96086,23,7,17,0,1182,1205
97604,23,5,17,0,1182,1205
103051,7,1,17,0,1182,1189
9912,3,1,17,0,1183,1186
11435,64,3,18,1,1183,1247
12381,68,1,18,0,1183,1251
16701,68,1,18,0,1183,1251
17584,3,2,17,0,1183,1186
18961,68,1,18,0,1183,1251
19232,3,1,17,0,1183,1186
20658,45,1,18,0,1183,1228
21336,22,7,17,0,1183,1205
26169,62,1,18,0,1183,1245
28708,58,9,18,0,1183,1241
39696,18,1,17,0,1183,1201
40184,68,1,18,0,1183,1251
40923,45,1,18,0,1183,1228
47100,68,1,18,0,1183,1251
48903,24,3,17,1,1183,1207
51849,4,7,17,0,1183,1187
53308,45,2,18,0,1183,1228
56180,45,2,18,0,1183,1228
58645,45,3,18,0,1183,1228
58811,14,2,17,0,1183,1197
59049,58,2,18,0,1183,1241
63726,45,1,18,0,1183,1228
64241,62,1,18,0,1183,1245
68576,45,1,18,0,1183,1228
71083,14,2,17,0,1183,1197
71647,45,1,18,0,1183,1228
73114,16,4,17,1,1183,1199
74897,45,1,18,0,1183,1228
77682,69,2,18,0,1183,1252
82596,68,1,18,0,1183,1251
93401,45,1,18,0,1183,1228
97525,68,2,18,0,1183,1251
98155,45,1,18,0,1183,1228
103106,45,2,18,0,1183,1228
103136,45,1,18,0,1183,1228
109395,68,1,18,0,1183,1251
115484,45,1,18,0,1183,1228
120469,45,1,18,0,1183,1228
123232,69,1,18,0,1183,1252
126057,45,1,18,0,1183,1228
7547,47,2,18,0,1184,1231
11893,7,5,17,0,1184,1191
13653,18,2,17,1,1184,1202
14931,17,1,17,0,1184,1201
27363,68,2,18,0,1184,1252
30613,49,2,18,0,1184,1233
32503,68,2,18,0,1184,1252
35977,5,10,17,1,1184,1189
40774,16,1,17,0,1184,1200
42253,16,1,17,0,1184,1200
43463,7,3,17,1,1184,1191
43476,68,1,18,0,1184,1252
47892,16,1,17,0,1184,1200
51509,68,1,18,0,1184,1252
51778,68,3,18,0,1184,1252
52288,15,15,17,0,1184,1199
53474,16,3,17,0,1184,1200
53861,68,1,18,0,1184,1252
59358,57,2,18,0,1184,1241
60283,5,1,17,0,1184,1189
60569,70,1,18,0,1184,1254
61440,17,6,17,0,1184,1201
63536,68,2,18,0,1184,1252
65218,68,2,18,0,1184,1252
69455,16,1,17,0,1184,1200
71952,68,1,18,0,1184,1252
72857,16,1,17,0,1184,1200
73648,68,1,18,0,1184,1252
74461,16,1,17,0,1184,1200
75733,27,3,17,0,1184,1211
77400,68,1,18,0,1184,1252
83844,16,1,17,0,1184,1200
86586,57,4,18,0,1184,1241
88352,68,1,18,0,1184,1252
88625,68,1,18,0,1184,1252
90088,68,1,18,0,1184,1252
91009,68,1,18,0,1184,1252
96561,68,2,18,0,1184,1252
100069,68,1,18,0,1184,1252
104632,68,2,18,0,1184,1252
109538,70,2,18,0,1184,1254
116877,11,1,17,0,1184,1195
118805,16,4,17,0,1184,1200
125648,19,2,17,0,1184,1203
125840,12,2,17,0,1184,1196
129512,68,1,18,0,1184,1252
129748,68,13,18,0,1184,1252
16718,29,3,17,0,1185,1214
25025,55,4,18,0,1185,1240
31458,11,4,17,0,1185,1196
73053,29,9,17,0,1185,1214
79675,9,6,17,0,1185,1194
94678,12,4,17,1,1185,1197
114824,20,3,17,0,1185,1205
7386,39,1,18,0,1186,1225
8843,39,1,18,0,1186,1225
10558,39,1,18,0,1186,1225
10762,39,1,18,0,1186,1225
14949,9,6,17,0,1186,1195
15859,39,2,18,0,1186,1225
15875,39,1,18,0,1186,1225
16046,39,1,18,0,1186,1225
17509,39,1,18,0,1186,1225
20206,39,1,18,0,1186,1225
21456,10,2,17,0,1186,1196
30609,39,1,18,0,1186,1225
32657,39,1,18,0,1186,1225
32890,39,1,18,0,1186,1225
33216,39,1,18,0,1186,1225
36098,39,2,18,0,1186,1225
38600,70,1,18,0,1186,1256
38769,39,1,18,0,1186,1225
38916,39,3,18,0,1186,1225
41757,14,1,17,1,1186,1200
44694,39,1,18,0,1186,1225
46606,39,2,18,0,1186,1225
47641,39,1,18,0,1186,1225
49454,92,1,19,0,1186,1278
52415,39,1,18,0,1186,1225
54396,13,1,17,0,1186,1199
55335,39,1,18,0,1186,1225
55910,11,2,17,0,1186,1197
60522,39,1,18,0,1186,1225
63900,39,2,18,0,1186,1225
64911,39,1,18,0,1186,1225
65131,39,4,18,0,1186,1225
66457,39,1,18,0,1186,1225
66785,39,1,18,0,1186,1225
68397,39,1,18,0,1186,1225
71168,39,2,18,0,1186,1225
72414,39,1,18,0,1186,1225
77280,39,1,18,0,1186,1225
78817,20,2,17,0,1186,1206
78961,39,1,18,0,1186,1225
80636,39,1,18,0,1186,1225
80696,19,1,17,0,1186,1205
87862,18,1,17,0,1186,1204
87992,39,1,18,0,1186,1225
88791,39,1,18,0,1186,1225
88903,39,1,18,0,1186,1225
90688,42,2,18,0,1186,1228
91011,39,2,18,0,1186,1225
91602,39,1,18,0,1186,1225
92697,39,1,18,0,1186,1225
93921,39,1,18,0,1186,1225
95778,39,1,18,0,1186,1225
97172,14,3,17,0,1186,1200
98380,39,1,18,0,1186,1225
98873,39,3,18,0,1186,1225
100751,39,1,18,0,1186,1225
101956,39,1,18,0,1186,1225
102896,39,1,18,0,1186,1225
105540,14,6,17,0,1186,1200
108087,39,3,18,0,1186,1225
108193,39,1,18,0,1186,1225
108486,39,1,18,0,1186,1225
109467,39,5,18,0,1186,1225
112191,18,1,17,0,1186,1204
122465,39,1,18,0,1186,1225
122518,39,1,18,0,1186,1225
122886,39,1,18,0,1186,1225
123526,39,1,18,0,1186,1225
123581,39,1,18,0,1186,1225
124152,46,4,18,1,1186,1232
127178,39,1,18,0,1186,1225
128027,14,5,17,0,1186,1200
10301,35,1,17,0,1187,1222
23525,35,1,17,0,1187,1222
33827,58,7,18,0,1187,1245
48891,3,1,17,0,1187,1190
54288,9,7,17,0,1187,1196
61817,35,1,17,0,1187,1222
78064,77,9,19,0,1187,1264
88833,38,4,18,0,1187,1225
115306,10,5,17,0,1187,1197
9334,91,2,19,0,1188,1279
47880,13,1,17,0,1188,1201
59028,51,6,18,0,1188,1239
79209,12,3,17,0,1188,1200
103624,5,5,17,0,1188,1193
106330,53,2,18,0,1188,1241
113422,78,3,19,1,1188,1266
119405,64,2,18,0,1188,1252
127137,21,1,17,0,1188,1209
21015,45,6,18,0,1189,1234
21753,12,6,17,0,1189,1201
39239,11,1,17,0,1189,1200
125037,11,1,17,0,1189,1200
66631,10,6,17,0,1190,1200
85995,24,8,17,0,1190,1214
92302,10,9,17,0,1190,1200
118291,5,4,17,0,1190,1195
12697,58,7,18,1,1191,1249
57358,15,5,17,0,1191,1206
59516,78,1,19,0,1191,1269
70023,78,1,19,0,1191,1269
127526,26,5,17,1,1191,1217
36550,15,2,17,0,1192,1207
57640,24,1,17,0,1192,1216
97340,12,1,17,0,1192,1204
115630,15,2,17,0,1192,1207
21318,61,1,18,0,1193,1254
22832,2,10,17,0,1193,1195
81738,9,5,17,1,1193,1202
96467,7,5,17,1,1193,1200
72709,72,2,19,0,1194,1266
77753,15,5,17,0,1194,1209
106007,15,3,17,0,1194,1209
118053,11,7,17,0,1194,1205
17861,39,1,18,0,1195,1234
21306,39,1,18,0,1195,1234
57314,39,1,18,0,1195,1234
63593,18,2,17,0,1195,1213
64502,39,1,18,0,1195,1234
66565,39,1,18,0,1195,1234
68399,3,7,17,0,1195,1198
68758,39,5,18,0,1195,1234
70301,32,3,18,0,1195,1227
72873,31,2,18,1,1195,1226
79222,39,1,18,0,1195,1234
81923,16,2,17,0,1195,1211
92498,39,1,18,0,1195,1234
93819,39,2,18,0,1195,1234
95955,39,1,18,0,1195,1234
106832,7,7,17,1,1195,1202
107886,39,2,18,0,1195,1234
110919,18,2,17,0,1195,1213
114480,63,5,18,1,1195,1258
121373,13,2,17,0,1195,1208
12793,30,1,18,0,1196,1226
16520,77,1,19,0,1196,1273
18898,77,1,19,0,1196,1273
63495,17,2,17,0,1196,1213
74958,46,1,18,0,1196,1242
79445,55,2,18,0,1196,1251
80179,12,2,17,0,1196,1208
111199,29,3,18,0,1196,1225
127704,4,5,17,1,1196,1200
24491,70,4,19,1,1197,1267
30629,21,2,17,0,1197,1218
32165,28,8,18,0,1197,1225
53624,11,4,17,0,1197,1208
64956,11,2,17,0,1197,1208
66479,4,3,17,0,1197,1201
81383,55,6,18,1,1197,1252
81589,19,3,17,0,1197,1216
83415,18,5,17,0,1197,1215
90138,41,12,18,1,1197,1238
90841,27,4,17,0,1197,1224
95968,36,2,18,0,1197,1233
103605,78,9,19,0,1197,1275
125567,52,2,18,0,1197,1249
14503,7,4,17,0,1198,1205
24085,76,1,19,0,1198,1274
39433,23,5,17,0,1198,1221
39866,35,3,18,1,1198,1233
43394,7,2,17,0,1198,1205
44886,18,8,17,1,1198,1216
61034,17,2,17,1,1198,1215
63261,10,3,17,0,1198,1208
71192,69,1,19,1,1198,1267
100081,71,3,19,1,1198,1269
103037,51,2,18,1,1198,1249
111712,9,3,17,0,1198,1207
116196,61,4,18,1,1198,1259
126710,2,13,17,0,1198,1200
129065,76,1,19,0,1198,1274
7551,7,3,17,0,1199,1206
12408,63,3,19,0,1199,1262
27655,26,2,18,0,1199,1225
54207,7,1,17,0,1199,1206
60283,2,2,17,0,1199,1201
88136,41,4,18,0,1199,1240
88643,67,1,19,1,1199,1266
7909,3,10,17,0,1200,1203
18416,12,3,17,0,1200,1212
21121,43,4,18,0,1200,1243
58985,40,4,18,0,1200,1240
67254,17,2,17,0,1200,1217
72591,63,1,19,0,1200,1263
81446,30,1,18,0,1200,1230
84126,17,5,17,0,1200,1217
86766,66,6,19,0,1200,1266
94105,16,4,17,0,1200,1216
55727,28,4,18,1,1201,1229
117156,16,4,17,0,1201,1217
129609,10,3,17,0,1201,1211
20081,12,2,17,0,1202,1214
22253,14,1,17,0,1202,1216
22832,3,11,17,0,1202,1205
47669,11,5,17,0,1202,1213
52977,51,2,18,0,1202,1253
69091,4,3,17,0,1202,1206
76004,27,1,18,0,1202,1229
92939,12,2,17,1,1202,1214
95662,52,6,18,0,1202,1254
105480,39,5,18,0,1202,1241
109348,66,1,19,0,1202,1268
16151,10,4,17,0,1203,1213
24137,28,12,18,1,1203,1231
65657,9,1,17,0,1203,1212
70578,9,3,17,0,1203,1212
92424,12,6,17,0,1203,1215
111786,10,4,17,0,1203,1213
112518,75,1,19,0,1203,1278
13762,7,4,17,0,1204,1211
21753,47,7,18,0,1204,1251
32887,8,4,17,0,1204,1212
39712,24,4,18,1,1204,1228
47880,71,2,19,0,1204,1275
60283,10,3,17,0,1204,1214
76576,40,2,18,0,1204,1244
79209,43,4,18,0,1204,1247
105801,41,2,18,0,1204,1245
122648,24,1,18,1,1204,1228
125037,48,2,18,0,1204,1252
7909,3,11,17,0,1205,1208
10153,49,1,18,1,1205,1254
13347,47,5,18,0,1205,1252
13653,20,3,18,1,1205,1225
14931,7,2,17,0,1205,1212
25672,14,5,17,0,1205,1219
31592,42,1,18,0,1205,1247
33784,6,1,17,0,1205,1211
43491,5,5,17,0,1205,1210
54436,33,4,18,0,1205,1238
57746,39,2,18,0,1205,1244
61761,23,3,18,0,1205,1228
63242,8,4,17,1,1205,1213
65765,6,3,17,0,1205,1211
66128,7,2,17,0,1205,1212
68641,49,1,18,0,1205,1254
68731,9,6,17,0,1205,1214
75444,39,3,18,0,1205,1244
84413,42,1,18,0,1205,1247
86400,20,4,18,0,1205,1225
87200,20,2,18,0,1205,1225
91889,5,5,17,0,1205,1210
102093,39,2,18,0,1205,1244
8821,6,5,17,0,1206,1212
11118,6,2,17,0,1206,1212
12233,6,2,17,0,1206,1212
15985,36,2,18,0,1206,1242
16595,23,9,18,0,1206,1229
18739,6,4,17,0,1206,1212
21639,12,5,17,1,1206,1218
22280,6,2,17,0,1206,1212
25465,6,2,17,0,1206,1212
31458,6,5,17,0,1206,1212
36761,6,5,17,0,1206,1212
39239,46,2,18,0,1206,1252
41805,50,1,18,1,1206,1256
48020,39,2,18,0,1206,1245
50679,7,5,17,0,1206,1213
53474,7,4,17,0,1206,1213
54031,23,1,18,0,1206,1229
54448,6,2,17,0,1206,1212
56915,6,2,17,0,1206,1212
57391,6,3,17,0,1206,1212
58811,40,3,18,0,1206,1246
61646,6,2,17,0,1206,1212
62785,7,7,17,0,1206,1213
68995,21,1,18,0,1206,1227
69204,3,3,17,0,1206,1209
71083,40,3,18,0,1206,1246
76454,6,3,17,0,1206,1212
77036,6,2,17,0,1206,1212
84847,23,1,18,0,1206,1229
88848,32,1,18,0,1206,1238
93210,6,2,17,0,1206,1212
93889,69,1,19,0,1206,1275
94971,6,2,17,0,1206,1212
95073,6,2,17,0,1206,1212
99851,6,3,17,0,1206,1212
101602,35,2,18,0,1206,1241
101658,19,1,18,0,1206,1225
104400,6,3,17,0,1206,1212
106053,8,3,17,0,1206,1214
108808,3,9,17,0,1206,1209
117960,6,2,17,0,1206,1212
118052,46,5,18,1,1206,1252
120872,6,3,17,0,1206,1212
125840,40,3,18,0,1206,1246
127682,6,2,17,0,1206,1212
14985,42,2,18,0,1207,1249
17612,56,1,19,0,1207,1263
18021,21,3,18,0,1207,1228
19173,2,2,17,0,1207,1209
31946,4,4,17,0,1207,1211
38261,49,1,18,0,1207,1256
43885,4,4,17,0,1207,1211
60619,58,2,19,0,1207,1265
66841,68,1,19,0,1207,1275
77191,45,2,18,0,1207,1252
84484,4,4,17,0,1207,1211
84894,9,1,17,0,1207,1216
103051,39,2,18,0,1207,1246
112898,45,2,18,0,1207,1252
119068,6,3,17,0,1207,1213
122713,31,4,18,0,1207,1238
129746,40,2,18,0,1207,1247
21837,5,6,17,1,1208,1213
108788,46,1,18,0,1208,1254
10110,13,1,17,0,1209,1222
21482,42,2,18,0,1209,1251
23304,40,3,18,0,1209,1249
27531,36,1,18,0,1209,1245
42605,37,2,18,0,1209,1246
51200,40,3,18,0,1209,1249
61440,29,7,18,0,1209,1238
67976,4,1,17,0,1209,1213
73465,40,1,18,0,1209,1249
98974,49,1,18,0,1209,1258
104465,31,2,18,0,1209,1240
106659,41,2,18,1,1209,1250
118011,56,3,19,0,1209,1265
122344,65,1,19,0,1209,1274
9791,17,8,18,0,1210,1227
11893,4,6,17,0,1210,1214
11970,51,2,19,0,1210,1261
15782,32,3,18,0,1210,1242
20699,15,6,18,0,1210,1225
22832,53,12,19,0,1210,1263
24120,4,3,17,0,1210,1214
24933,34,2,18,0,1210,1244
31958,30,2,18,0,1210,1240
35425,32,3,18,0,1210,1242
36285,14,3,17,0,1210,1224
58522,28,5,18,0,1210,1238
78545,36,2,18,0,1210,1246
79921,36,2,18,0,1210,1246
81540,4,3,17,0,1210,1214
85726,30,4,18,0,1210,1240
86565,6,2,17,0,1210,1216
97604,13,6,17,0,1210,1223
100425,4,3,17,0,1210,1214
103519,36,2,18,0,1210,1246
104037,26,3,18,0,1210,1236
110485,15,1,18,0,1210,1225
113290,30,2,18,0,1210,1240
119260,4,4,17,0,1210,1214
119820,36,4,18,0,1210,1246
125314,4,3,17,0,1210,1214
127796,52,3,19,0,1210,1262
128714,39,2,18,0,1210,1249
14711,14,6,18,0,1211,1225
30817,44,7,18,0,1211,1255
30864,39,1,18,0,1211,1250
54428,14,1,18,0,1211,1225
79864,40,2,18,0,1211,1251
117070,29,6,18,0,1211,1240
123043,35,2,18,0,1211,1246
126620,35,4,18,0,1211,1246
16329,26,1,18,0,1212,1238
17115,37,4,18,0,1212,1249
24333,2,4,17,0,1212,1214
27482,39,3,18,0,1212,1251
28258,53,2,19,0,1212,1265
57358,16,6,18,0,1212,1228
59215,2,4,17,0,1212,1214
78817,13,3,18,0,1212,1225
81720,35,1,18,0,1212,1247
87073,16,2,18,0,1212,1228
91573,14,5,18,0,1212,1226
116645,30,2,18,0,1212,1242
9732,26,2,18,0,1213,1239
26607,31,2,18,0,1213,1244
35665,31,2,18,0,1213,1244
70829,39,1,18,0,1213,1252
72232,29,2,18,0,1213,1242
73114,23,5,18,1,1213,1236
79289,29,2,18,0,1213,1242
82143,28,2,18,0,1213,1241
94295,31,4,18,0,1213,1244
95658,13,7,18,0,1213,1226
97281,31,2,18,0,1213,1244
98064,33,2,18,0,1213,1246
101239,33,2,18,0,1213,1246
105890,28,2,18,0,1213,1241
112505,31,2,18,0,1213,1244
114824,39,4,18,0,1213,1252
120944,29,2,18,0,1213,1242
23521,39,3,18,1,1214,1253
37188,45,2,18,1,1214,1259
67744,64,8,19,0,1214,1278
86299,11,4,18,0,1214,1225
91566,11,4,18,0,1214,1225
116877,11,2,18,0,1214,1225
16321,39,1,18,0,1215,1254
113887,7,3,17,0,1215,1222
126710,20,14,18,0,1215,1235
6551,23,1,18,1,1219,1242
13277,16,1,18,0,1219,1235
41757,6,2,18,1,1219,1225
80179,21,3,18,0,1219,1240
21639,40,6,19,1,1220,1260
48563,14,1,18,0,1220,1234
61553,14,1,18,0,1220,1234
90006,14,1,18,0,1220,1234
128769,14,1,18,0,1220,1234
78652,33,1,18,1,1221,1254
129300,34,2,18,1,1221,1255
7401,10,1,18,0,1222,1232
18747,10,2,18,0,1222,1232
31285,10,1,18,0,1222,1232
41090,10,2,18,0,1222,1232
68731,10,7,18,0,1222,1232
103058,10,2,18,0,1222,1232
115630,34,3,18,0,1222,1256
48633,23,1,18,0,1223,1246
60283,25,4,18,0,1223,1248
92424,36,7,18,0,1223,1259
107922,11,4,18,0,1223,1234
108808,15,10,18,0,1223,1238
6677,16,2,18,0,1224,1240
94386,11,4,18,0,1224,1235
94678,30,5,18,1,1224,1254
121906,27,1,18,1,1224,1251
9912,3,2,18,0,1225,1228
14949,9,7,18,0,1225,1234
17584,3,3,18,0,1225,1228
28125,40,4,19,1,1225,1265
33568,11,3,18,0,1225,1236
81923,10,3,18,0,1225,1235
87035,4,1,18,0,1225,1229
87862,28,2,18,0,1225,1253
111167,21,2,18,0,1225,1246
119068,22,4,18,0,1225,1247
51492,15,2,18,0,1226,1241
52216,35,3,19,1,1226,1261
66128,9,3,18,0,1226,1235
104612,23,5,18,1,1226,1249
105389,12,4,18,0,1226,1238
22139,40,3,19,0,1227,1267
127576,21,1,18,1,1227,1248
46896,36,5,19,1,1228,1264
57358,34,7,19,0,1228,1262
63889,29,4,18,1,1228,1257
64875,13,2,18,0,1228,1241
118291,12,5,18,0,1228,1240
120872,14,4,18,0,1228,1242
121560,46,2,19,0,1228,1274
127682,16,3,18,0,1228,1244
39257,17,2,18,1,1229,1246
59251,14,3,18,0,1229,1243
99422,15,2,18,0,1229,1244
127704,10,6,18,1,1229,1239
47001,4,1,18,0,1230,1234
48903,33,4,19,1,1230,1263
65858,15,2,18,1,1230,1245
86635,15,4,18,1,1230,1245
14931,14,3,18,0,1231,1245
20712,11,1,18,0,1231,1242
35163,40,1,19,0,1231,1271
37387,11,1,18,0,1231,1242
49175,24,4,18,0,1231,1255
118076,11,1,18,0,1231,1242
125749,22,7,18,1,1231,1253
44886,9,9,18,1,1232,1241
101135,11,2,18,1,1232,1243
103882,16,5,18,1,1232,1248
113482,15,2,18,1,1232,1247
35977,16,11,18,1,1233,1249
69666,32,8,19,1,1233,1265
93936,10,2,18,0,1233,1243
36170,11,1,18,0,1234,1245
54851,5,5,18,1,1234,1239
61034,33,3,19,1,1234,1267
67376,11,4,18,0,1234,1245
72873,9,3,18,1,1234,1243
88418,9,3,18,0,1234,1243
110919,9,3,18,0,1234,1243
68995,8,2,18,0,1235,1243
84847,40,2,19,0,1235,1275
9791,3,9,18,0,1236,1239
91573,3,6,18,0,1236,1239
112910,10,4,18,0,1236,1246
113887,3,4,18,0,1236,1239
14949,5,8,18,0,1238,1243
24333,35,5,19,0,1238,1273
36210,5,2,18,1,1238,1243
81474,38,6,19,0,1238,1276
12157,25,3,19,1,1239,1264
20593,33,3,19,0,1239,1272
48843,39,2,19,0,1239,1278
127469,7,13,18,1,1239,1246
15114,7,3,18,0,1240,1247
27554,38,3,19,0,1240,1278
52314,38,2,19,0,1240,1278
63785,8,2,18,0,1240,1248
66128,21,4,19,1,1240,1261
81910,11,3,18,0,1240,1251
94854,25,6,19,0,1240,1265
7547,14,3,18,0,1241,1255
20081,16,3,18,0,1241,1257
52873,32,2,19,0,1241,1273
61199,21,4,19,0,1241,1262
67686,2,3,18,0,1241,1243
73797,35,2,19,0,1241,1276
107725,19,4,19,0,1241,1260
120187,35,3,19,0,1241,1276
22137,6,4,18,0,1242,1248
36550,10,3,18,0,1242,1252
109122,13,3,18,0,1242,1255
7774,32,2,19,0,1243,1275
17752,10,3,18,0,1243,1253
57314,32,2,19,0,1243,1275
57780,3,5,18,0,1243,1246
64956,35,3,19,0,1243,1278
68758,32,6,19,0,1243,1275
73114,11,6,18,1,1243,1254
73653,32,2,19,0,1243,1275
79222,32,2,19,0,1243,1275
88531,11,1,18,0,1243,1254
102670,32,2,19,0,1243,1275
103668,11,7,18,0,1243,1254
117745,32,2,19,0,1243,1275
120302,32,2,19,0,1243,1275
125959,16,1,18,0,1243,1259
127526,4,6,18,1,1243,1247
129792,32,2,19,0,1243,1275
8865,13,1,18,0,1244,1257
16595,9,10,18,0,1244,1253
27655,31,3,19,0,1244,1275
55899,22,11,19,1,1244,1266
68327,21,3,19,0,1244,1265
81589,34,4,19,0,1244,1278
106007,34,4,19,0,1244,1278
23861,10,1,18,0,1245,1255
27716,9,3,18,0,1245,1254
28708,7,10,18,0,1245,1252
30613,7,3,18,0,1245,1252
46370,7,2,18,0,1245,1252
57640,28,2,19,0,1245,1273
98263,7,2,18,0,1245,1252
13772,28,1,19,0,1246,1274
53188,10,9,18,0,1246,1256
55754,8,1,18,0,1246,1254
61761,11,4,18,0,1246,1257
68731,9,8,18,0,1246,1255
75738,8,4,18,0,1246,1254
96464,9,1,18,0,1246,1255
105389,31,5,19,0,1246,1277
118380,17,5,19,0,1246,1263
123775,9,1,18,0,1246,1255
13653,30,4,19,1,1247,1277
20115,15,3,19,0,1247,1262
26438,15,1,19,0,1247,1262
38693,17,4,19,0,1247,1264
40740,28,3,19,0,1247,1275
83415,15,6,19,0,1247,1262
86586,4,5,18,0,1247,1251
7909,19,12,19,0,1248,1267
18015,3,8,18,0,1248,1251
51855,15,4,19,1,1248,1263
57437,3,2,18,0,1248,1251
65657,22,2,19,0,1248,1270
69455,3,2,18,0,1248,1251
77642,30,9,19,0,1248,1278
82236,4,1,18,0,1248,1252
99677,6,4,18,0,1248,1254
107922,2,5,18,0,1248,1250
111663,14,3,19,0,1248,1262
119609,6,5,18,0,1248,1254
13277,8,2,18,0,1249,1257
33753,4,9,18,0,1249,1253
34341,18,2,19,0,1249,1267
48654,29,3,19,0,1249,1278
55305,18,3,19,0,1249,1267
87666,18,2,19,0,1249,1267
125767,18,2,19,1,1249,1267
129181,18,1,19,0,1249,1267
7054,16,2,19,0,1250,1266
7125,16,1,19,0,1250,1266
16718,2,4,18,0,1250,1252
41271,25,5,19,0,1250,1275
44063,16,1,19,0,1250,1266
48563,6,2,18,0,1250,1256
61553,6,2,18,0,1250,1256
70582,3,5,18,0,1250,1253
86400,14,5,19,0,1250,1264
90006,6,2,18,0,1250,1256
105465,3,2,18,0,1250,1253
108403,28,3,19,0,1250,1278
118257,16,1,19,0,1250,1266
126021,16,2,19,0,1250,1266
129609,12,4,19,0,1250,1262
41104,4,3,18,0,1251,1255
91745,27,3,19,0,1251,1278
101658,11,2,19,0,1251,1262
5596,3,8,18,0,1252,1255
40886,3,4,18,0,1252,1255
57780,11,6,19,0,1252,1263
108759,26,3,19,0,1252,1278
128769,2,2,18,0,1252,1254
20761,10,3,19,0,1253,1263
23228,10,5,19,0,1253,1263
30398,9,5,19,0,1253,1262
43281,10,3,19,0,1253,1263
47010,10,3,19,0,1253,1263
75444,10,4,19,0,1253,1263
78131,23,7,19,0,1253,1276
78444,10,3,19,0,1253,1263
87200,10,3,19,0,1253,1263
104285,10,5,19,0,1253,1263
108398,10,5,19,0,1253,1263
112106,10,3,19,0,1253,1263
114032,10,3,19,0,1253,1263
115979,10,3,19,0,1253,1263
128948,10,3,19,0,1253,1263
33827,14,8,19,1,1254,1268
55727,2,5,18,1,1254,1256
59251,15,4,19,0,1254,1269
95054,5,1,18,1,1254,1259
117405,8,1,19,0,1254,1262
32404,21,2,19,0,1255,1276
68390,5,3,19,0,1255,1260
109087,7,4,19,0,1255,1262
13280,3,4,18,0,1256,1259
24137,9,13,19,1,1256,1265
27482,3,4,18,0,1256,1259
55910,3,3,18,0,1256,1259
101237,4,2,19,0,1257,1261
105480,4,6,19,0,1257,1261
38600,19,2,19,0,1259,1278
119405,17,3,19,0,1259,1276
119609,19,6,19,0,1259,1278
9812,2,2,19,0,1260,1262
24585,15,5,19,0,1260,1275
65209,3,1,19,0,1260,1263
76563,18,4,19,0,1260,1278
87225,9,3,19,0,1260,1269
90234,15,2,19,0,1260,1275
105540,3,7,19,0,1260,1263
124951,5,3,19,0,1260,1265
5596,12,9,19,0,1261,1273
20081,4,4,19,0,1261,1265
80592,11,3,19,0,1261,1272
85995,17,9,19,0,1261,1278
9312,9,2,19,0,1262,1271
17752,13,4,19,0,1262,1275
27482,16,5,19,0,1262,1278
60569,13,2,19,0,1262,1275
109538,13,3,19,0,1262,1275
122434,14,2,19,0,1262,1276
21562,7,3,19,0,1263,1270
22135,14,6,19,0,1263,1277
29693,16,3,19,0,1263,1279
60283,12,5,19,0,1263,1275
67869,12,4,19,0,1263,1275
13347,12,6,19,0,1264,1276
22137,4,5,19,0,1264,1268
26145,11,4,19,0,1264,1275
43491,11,6,19,0,1264,1275
51849,10,8,19,0,1264,1274
86793,11,4,19,0,1264,1275
91889,11,6,19,0,1264,1275
108089,10,2,19,0,1264,1274
113338,11,2,19,0,1264,1275
38192,11,4,19,0,1265,1276
65765,10,4,19,0,1265,1275
78740,3,6,19,0,1265,1268
98263,3,3,19,0,1265,1268
102338,11,2,19,0,1265,1276
40886,8,5,19,0,1267,1275
16029,10,1,19,0,1268,1278
82658,10,2,19,0,1268,1278
122485,7,4,19,0,1268,1275
87200,5,4,19,0,1269,1274
7909,2,13,19,0,1274,1276
