dummyCell,boutLength,boutNo,vep,center,start,end
10025,44,1,6,1,600,644
13306,44,1,6,1,600,644
52792,44,1,6,1,600,644
65556,91,1,6,1,600,691
75071,29,1,6,0,600,629
85347,39,1,6,1,600,639
95039,17,1,6,1,600,617
112330,50,1,6,1,600,650
121434,29,1,6,0,600,629
69151,43,1,6,1,601,644
5737,26,1,6,0,602,628
17407,26,1,6,0,602,628
63896,26,1,6,0,602,628
76000,26,1,6,0,602,628
90790,26,1,6,0,602,628
100334,26,1,6,0,602,628
106080,26,1,6,0,602,628
110074,26,1,6,0,602,628
40779,23,1,6,0,603,626
125035,25,1,6,0,603,628
17521,23,1,6,0,604,627
21306,22,1,6,0,604,626
72214,13,1,6,0,604,617
82822,21,1,6,0,604,625
88011,22,1,6,0,604,626
110218,22,1,6,0,604,626
6720,20,1,6,0,605,625
6869,20,1,6,0,605,625
7292,20,1,6,0,605,625
8448,20,1,6,0,605,625
12162,20,1,6,0,605,625
12185,20,1,6,0,605,625
12304,20,1,6,0,605,625
16573,20,1,6,0,605,625
17388,20,1,6,0,605,625
18581,20,1,6,0,605,625
20885,20,1,6,0,605,625
22038,20,1,6,0,605,625
26864,20,1,6,0,605,625
32849,22,1,6,0,605,627
35729,20,1,6,0,605,625
37382,20,1,6,0,605,625
37520,20,1,6,0,605,625
39564,20,1,6,0,605,625
45146,20,1,6,0,605,625
45848,20,1,6,0,605,625
48789,20,1,6,0,605,625
50650,20,1,6,0,605,625
52049,20,1,6,0,605,625
56821,20,1,6,0,605,625
57047,21,1,6,0,605,626
61164,20,1,6,0,605,625
63839,20,1,6,0,605,625
63840,20,1,6,0,605,625
63886,22,1,6,0,605,627
65690,20,1,6,0,605,625
65765,20,1,6,0,605,625
66415,20,1,6,0,605,625
66645,20,1,6,0,605,625
67236,20,1,6,0,605,625
67292,20,1,6,0,605,625
69301,119,1,6,1,605,724
71512,20,1,6,0,605,625
73685,20,1,6,0,605,625
78047,20,1,6,0,605,625
78961,21,1,6,0,605,626
81371,20,1,6,0,605,625
82443,20,1,6,0,605,625
82903,20,1,6,0,605,625
84673,20,1,6,0,605,625
84975,20,1,6,0,605,625
85055,20,1,6,0,605,625
85235,20,1,6,0,605,625
85827,20,1,6,0,605,625
86216,20,1,6,0,605,625
86242,20,1,6,0,605,625
91996,20,1,6,0,605,625
93213,20,1,6,0,605,625
96544,20,1,6,0,605,625
100464,20,1,6,0,605,625
102868,20,1,6,0,605,625
104419,20,1,6,0,605,625
105699,20,1,6,0,605,625
110824,20,1,6,0,605,625
111200,20,1,6,0,605,625
111416,20,1,6,0,605,625
111564,20,1,6,0,605,625
112152,20,1,6,0,605,625
112294,20,1,6,0,605,625
113140,11,1,6,0,605,616
114841,20,1,6,0,605,625
119472,20,1,6,0,605,625
119519,20,1,6,0,605,625
120927,20,1,6,0,605,625
121790,20,1,6,0,605,625
123445,20,1,6,0,605,625
125315,20,1,6,0,605,625
126008,20,1,6,0,605,625
34810,18,1,6,0,606,624
40937,19,1,6,0,606,625
64520,118,1,6,1,606,724
74394,96,1,6,0,606,702
82167,26,1,6,1,606,632
106632,9,1,6,0,606,615
112094,26,1,6,1,606,632
128340,10,1,6,0,606,616
9836,9,1,6,0,607,616
14219,17,1,6,0,607,624
20828,17,1,6,0,607,624
24563,17,1,6,0,607,624
25397,9,1,6,0,607,616
34670,17,1,6,0,607,624
36002,17,1,6,0,607,624
40113,19,1,6,0,607,626
40694,17,1,6,0,607,624
43066,18,1,6,0,607,625
48762,17,1,6,0,607,624
56143,19,1,6,0,607,626
61143,17,1,6,0,607,624
64168,17,1,6,0,607,624
68171,17,1,6,0,607,624
89197,9,1,6,0,607,616
92059,17,1,6,0,607,624
98049,18,1,6,0,607,625
99280,17,1,6,0,607,624
102208,17,1,6,0,607,624
102997,17,1,6,0,607,624
105710,17,1,6,0,607,624
108461,17,1,6,0,607,624
125464,17,1,6,0,607,624
91802,17,1,6,0,608,625
117196,16,1,6,0,609,625
32369,20,1,6,0,610,630
102427,15,1,6,0,610,625
83050,13,1,6,0,611,624
115078,19,1,6,0,611,630
18878,17,1,6,0,612,629
43837,12,1,6,0,612,624
15077,14,1,6,0,613,627
22385,12,1,6,0,613,625
45482,15,1,6,0,613,628
82734,15,1,6,0,613,628
102703,15,1,6,0,613,628
114063,15,1,6,0,613,628
38199,13,1,6,0,614,627
55397,102,1,6,1,614,716
57636,13,1,6,0,614,627
67280,13,1,6,0,614,627
88004,13,1,6,0,614,627
107461,28,1,6,0,614,642
111523,13,1,6,0,614,627
112483,22,1,6,0,614,636
123634,13,1,6,0,614,627
13391,11,1,6,0,615,626
17172,11,1,6,0,615,626
17500,11,1,6,0,615,626
20019,11,1,6,0,615,626
47284,10,1,6,0,615,625
56207,11,1,6,0,615,626
67004,11,1,6,0,615,626
71698,9,1,6,0,615,624
103662,11,1,6,0,615,626
117809,11,1,6,0,615,626
8285,7,1,6,0,616,623
17890,106,1,6,1,616,722
59034,9,1,6,0,616,625
63266,9,1,6,0,616,625
69754,9,1,6,0,616,625
72351,9,1,6,0,616,625
81582,8,1,6,0,616,624
82456,9,1,6,0,616,625
83256,9,1,6,0,616,625
89992,9,1,6,0,616,625
97026,9,1,6,0,616,625
101824,8,1,6,0,616,624
116509,9,1,6,0,616,625
119437,9,1,6,0,616,625
121202,9,1,6,0,616,625
9263,8,1,6,0,617,625
14489,8,1,6,0,617,625
18568,7,1,6,0,617,624
22073,7,1,6,0,617,624
24433,7,1,6,0,617,624
24957,8,1,6,0,617,625
26027,8,1,6,0,617,625
26611,7,1,6,0,617,624
29458,7,1,6,0,617,624
35021,7,1,6,0,617,624
35360,7,1,6,0,617,624
46817,7,1,6,0,617,624
48601,8,1,6,0,617,625
48717,8,1,6,0,617,625
49303,8,1,6,0,617,625
53485,7,1,6,0,617,624
61876,8,1,6,0,617,625
62360,8,1,6,0,617,625
63441,8,1,6,0,617,625
69009,7,1,6,0,617,624
70536,7,1,6,0,617,624
71403,7,1,6,0,617,624
72874,8,1,6,0,617,625
78175,8,1,6,0,617,625
79886,8,1,6,0,617,625
81424,8,1,6,0,617,625
82771,7,1,6,0,617,624
83252,7,1,6,0,617,624
87015,7,1,6,0,617,624
89444,8,1,6,0,617,625
92781,8,1,6,0,617,625
95204,7,1,6,0,617,624
95563,8,1,6,0,617,625
101700,8,1,6,0,617,625
103547,19,1,6,0,617,636
103626,8,1,6,0,617,625
107761,7,1,6,0,617,624
112171,7,1,6,0,617,624
116828,7,1,6,0,617,624
118915,8,1,6,0,617,625
121758,8,1,6,0,617,625
122283,7,1,6,0,617,624
125514,8,1,6,0,617,625
49251,4,1,6,0,618,622
62282,4,1,6,0,618,622
94941,3,1,6,0,619,622
57809,24,1,6,1,622,646
9691,76,1,6,0,623,699
17446,76,1,6,0,623,699
37474,7,1,6,0,625,632
68840,7,1,6,0,625,632
88232,7,1,6,0,625,632
94282,7,1,6,0,625,632
97533,7,1,6,0,625,632
118746,7,1,6,0,625,632
31218,17,1,6,0,628,645
99483,22,1,6,0,628,650
9263,6,2,6,0,630,636
14489,17,2,6,0,630,647
24957,27,2,6,0,630,657
26027,6,2,6,0,630,636
40113,5,2,6,0,630,635
45482,6,2,6,0,630,636
46817,18,2,6,0,630,648
47284,17,2,6,0,630,647
48601,6,2,6,0,630,636
48717,7,2,6,0,630,637
49303,6,2,6,0,630,636
56143,5,2,6,0,630,635
57047,5,2,6,0,630,635
61876,6,2,6,0,630,636
63441,6,2,6,0,630,636
67236,6,2,6,0,630,636
69754,17,2,6,0,630,647
72874,6,2,6,0,630,636
78175,27,2,6,0,630,657
81424,6,2,6,0,630,636
89444,6,2,6,0,630,636
92781,17,2,6,0,630,647
95563,7,2,6,0,630,637
98049,6,2,6,0,630,636
101700,6,2,6,0,630,636
102342,2,1,6,1,630,632
103626,6,2,6,0,630,636
118915,17,2,6,0,630,647
121758,6,2,6,0,630,636
125514,6,2,6,0,630,636
79886,4,2,6,0,631,635
13285,50,1,6,1,632,682
76951,4,1,6,0,632,636
118255,79,1,6,1,632,711
18209,98,1,7,1,633,731
37487,51,1,6,1,633,684
85984,53,1,6,0,633,686
10399,76,1,6,0,634,710
36877,67,1,6,0,634,701
51091,48,1,6,0,634,682
74419,67,1,6,0,634,701
21885,47,1,6,0,635,682
36793,46,1,6,0,635,681
55689,9,1,6,0,635,644
97901,24,1,6,0,635,659
58175,16,1,6,1,636,652
68840,8,2,6,0,636,644
74697,81,1,6,1,636,717
100221,25,1,6,0,636,661
6720,18,2,6,0,637,655
9667,14,1,6,0,637,651
24390,16,1,6,0,637,653
40470,16,1,6,0,637,653
45178,16,1,6,0,637,653
49251,10,2,6,0,637,647
60697,71,1,6,1,637,708
71698,10,2,6,0,637,647
72214,11,2,6,0,637,648
82432,10,1,6,0,637,647
88880,19,1,6,0,637,656
98399,18,1,6,0,637,655
101824,11,2,6,0,637,648
127062,45,1,6,1,637,682
8448,9,2,6,0,638,647
23018,19,1,6,0,638,657
25397,19,2,6,0,638,657
31643,19,1,6,0,638,657
36253,19,1,6,0,638,657
46303,17,1,6,0,638,655
47439,19,1,6,0,638,657
58392,24,1,6,1,638,662
64847,19,1,6,0,638,657
75128,19,1,6,0,638,657
78062,13,1,6,0,638,651
85784,59,1,6,0,638,697
89197,19,2,6,0,638,657
103547,71,2,6,0,638,709
112130,19,1,6,0,638,657
121434,41,2,6,0,638,679
16719,37,1,6,0,639,676
44367,39,1,6,0,639,678
97953,15,1,6,0,639,654
107180,50,1,6,0,639,689
122526,39,1,6,0,639,678
125006,15,1,6,0,639,654
125459,15,1,6,0,639,654
76605,15,1,6,0,640,655
106632,42,2,6,0,640,682
24809,15,1,6,0,641,656
40779,9,2,6,0,641,650
62305,8,1,6,0,641,649
9936,64,1,6,0,642,706
15108,57,1,6,0,642,699
16805,52,1,6,0,642,694
67321,13,1,6,0,642,655
88788,35,1,6,0,642,677
109272,21,1,6,0,642,663
9836,14,2,6,0,643,657
20302,33,1,6,0,643,676
40937,14,2,6,0,643,657
56038,4,1,6,0,643,647
69847,24,1,6,0,643,667
79863,7,1,6,0,643,650
89850,7,1,6,0,643,650
90078,33,1,6,0,643,676
99115,38,1,6,0,643,681
102032,4,1,6,0,643,647
105710,9,2,6,0,643,652
113140,38,2,6,0,643,681
14219,7,2,6,0,644,651
14877,7,1,6,0,644,651
17388,49,2,6,0,644,693
20828,7,2,6,0,644,651
32186,48,1,6,0,644,692
33806,94,1,7,1,644,738
34670,7,2,6,0,644,651
36002,7,2,6,0,644,651
40694,7,2,6,0,644,651
48762,7,2,6,0,644,651
61143,7,2,6,0,644,651
64168,7,2,6,0,644,651
68171,7,2,6,0,644,651
70193,18,1,6,0,644,662
92059,7,2,6,0,644,651
98049,7,3,6,0,644,651
99280,7,2,6,0,644,651
102208,7,2,6,0,644,651
108461,7,2,6,0,644,651
125464,7,2,6,0,644,651
23650,38,1,6,0,645,683
37474,52,2,6,0,645,697
39996,46,1,6,0,645,691
42651,46,1,6,0,645,691
44549,54,1,6,0,645,699
44570,39,1,6,0,645,684
44930,4,1,6,0,645,649
55047,63,1,6,1,645,708
55561,46,1,6,0,645,691
56606,46,1,6,0,645,691
70179,46,1,6,0,645,691
71403,52,2,6,0,645,697
72489,21,1,6,0,645,666
76000,46,2,6,0,645,691
83410,46,1,6,0,645,691
88232,52,2,6,0,645,697
93194,46,1,6,0,645,691
94282,52,2,6,0,645,697
94350,46,1,6,0,645,691
96150,46,1,6,0,645,691
97533,42,2,6,0,645,687
100010,46,1,6,0,645,691
106663,46,1,6,0,645,691
107195,46,1,6,0,645,691
116877,46,1,6,0,645,691
118746,52,2,6,0,645,697
123963,46,1,6,0,645,691
125501,46,1,6,0,645,691
18774,44,1,6,0,646,690
25137,50,1,6,0,647,697
62024,56,1,6,0,647,703
75072,24,1,6,0,647,671
77286,24,1,6,0,647,671
82167,50,2,6,1,647,697
95604,5,1,6,0,647,652
7281,18,1,6,0,648,666
8441,18,1,6,0,648,666
10401,18,1,6,0,648,666
10554,18,1,6,0,648,666
10731,18,1,6,0,648,666
11525,18,1,6,0,648,666
17229,18,1,6,0,648,666
17239,37,1,6,0,648,685
18935,18,1,6,0,648,666
19836,18,1,6,0,648,666
20682,18,1,6,0,648,666
20935,18,1,6,0,648,666
22121,18,1,6,0,648,666
25571,18,1,6,0,648,666
26072,13,1,6,0,648,661
30118,18,1,6,0,648,666
32849,33,2,6,0,648,681
36648,37,1,6,0,648,685
38029,18,1,6,0,648,666
38635,18,1,6,0,648,666
38993,18,1,6,0,648,666
41121,44,1,6,0,648,692
49872,18,1,6,0,648,666
49881,18,1,6,0,648,666
50650,18,2,6,0,648,666
51527,18,1,6,0,648,666
53277,18,1,6,0,648,666
54012,18,1,6,0,648,666
56071,18,1,6,0,648,666
57897,18,1,6,0,648,666
58382,18,1,6,0,648,666
63201,18,1,6,0,648,666
65546,18,1,6,0,648,666
69286,18,1,6,0,648,666
69833,18,1,6,0,648,666
71392,18,1,6,0,648,666
71567,23,1,6,1,648,671
73068,24,1,6,0,648,672
73691,18,1,6,0,648,666
74913,18,1,6,0,648,666
75007,18,1,6,0,648,666
78991,33,1,6,0,648,681
81009,46,1,6,0,648,694
81199,18,1,6,0,648,666
81330,18,1,6,0,648,666
82974,18,1,6,0,648,666
83982,18,1,6,0,648,666
90833,18,1,6,0,648,666
91674,18,1,6,0,648,666
94941,47,2,6,0,648,695
96179,43,1,6,0,648,691
98691,18,1,6,0,648,666
100626,47,1,6,0,648,695
101858,18,1,6,0,648,666
102284,18,1,6,0,648,666
113872,33,1,6,0,648,681
114362,18,1,6,0,648,666
116683,46,1,6,0,648,694
119111,18,1,6,0,648,666
120908,18,1,6,0,648,666
122911,18,1,6,0,648,666
122916,18,1,6,0,648,666
123022,18,1,6,0,648,666
124262,18,1,6,0,648,666
124874,37,1,6,0,648,685
127510,32,1,6,0,648,680
127547,18,1,6,0,648,666
127614,46,1,6,0,648,694
17071,38,1,6,0,649,687
18389,38,1,6,0,649,687
19359,38,1,6,0,649,687
20668,8,1,6,0,649,657
29849,38,1,6,0,649,687
39693,38,1,6,0,649,687
44617,13,1,6,0,649,662
49317,38,1,6,0,649,687
49935,38,1,6,0,649,687
55292,5,1,6,0,649,654
65453,38,1,6,0,649,687
81886,38,1,6,0,649,687
97074,38,1,6,0,649,687
97671,38,1,6,0,649,687
105792,19,1,6,0,649,668
105995,38,1,6,0,649,687
108024,25,1,6,1,649,674
16239,18,1,6,0,650,668
29029,18,1,6,0,650,668
34704,18,1,6,0,650,668
40786,34,1,6,0,650,684
45422,18,1,6,0,650,668
48000,18,1,6,0,650,668
54659,7,1,6,0,650,657
59438,13,1,6,0,650,663
71560,18,1,6,0,650,668
77418,18,1,6,0,650,668
78512,19,1,6,0,650,669
91946,18,1,6,0,650,668
115214,15,1,6,0,650,665
13767,11,1,6,0,651,662
22153,11,1,6,0,651,662
84784,19,1,6,0,651,670
5721,49,1,6,0,652,701
14533,40,1,6,1,652,692
33843,16,1,6,0,652,668
41866,50,1,6,0,652,702
62620,50,1,6,0,652,702
102342,8,2,6,1,652,660
112094,9,2,6,0,652,661
8013,13,1,6,0,653,666
9074,13,1,6,0,653,666
9775,13,1,6,0,653,666
24827,13,1,6,0,653,666
29458,57,2,6,0,653,710
68840,59,3,6,0,653,712
69022,13,1,6,0,653,666
72813,8,1,6,0,653,661
77749,8,1,6,0,653,661
77850,13,1,6,0,653,666
108931,13,1,6,0,653,666
120511,8,1,6,0,653,661
26883,13,1,6,0,654,667
82204,10,1,6,0,654,664
107702,10,1,6,0,654,664
125733,9,1,6,0,654,663
40889,44,1,6,0,655,699
45927,44,1,6,0,655,699
53314,44,1,6,0,655,699
55689,11,2,6,0,655,666
63063,40,1,6,0,655,695
70725,14,1,6,1,655,669
72250,15,1,6,0,655,670
87858,44,1,6,0,655,699
8492,7,1,6,0,656,663
9043,7,1,6,0,656,663
12959,7,1,6,0,656,663
19207,7,1,6,0,656,663
19308,7,1,6,0,656,663
34234,12,1,6,1,656,668
63657,7,1,6,0,656,663
95204,7,2,6,0,656,663
105699,19,2,6,0,656,675
123308,8,1,6,0,656,664
126455,7,1,6,0,656,663
6122,5,1,6,0,657,662
34254,5,1,6,0,657,662
36358,5,1,6,0,657,662
37262,5,1,6,0,657,662
39605,5,1,6,0,657,662
41540,8,1,6,0,657,665
63539,5,1,6,0,657,662
70150,11,1,6,1,657,668
73222,5,1,6,0,657,662
105080,5,1,6,0,657,662
14877,19,2,6,0,658,677
33248,8,1,6,0,658,666
40779,17,3,6,0,658,675
54974,3,1,6,0,658,661
65711,4,1,6,0,658,662
55292,22,2,6,0,659,681
41992,15,1,6,0,660,675
76605,19,2,6,0,660,679
82138,8,1,6,0,660,668
70209,10,1,6,0,661,671
97953,39,2,6,0,661,700
125006,20,2,6,0,661,681
125459,20,2,6,0,661,681
23018,16,2,6,0,662,678
24809,39,2,6,0,662,701
39564,9,2,6,0,662,671
67321,39,2,6,0,662,701
69867,9,1,6,0,662,671
24957,13,3,6,0,663,676
25397,17,3,6,0,663,680
31643,15,2,6,0,663,678
36253,15,2,6,0,663,678
47439,15,2,6,0,663,678
58175,37,2,6,1,663,700
61729,11,1,6,0,663,674
64847,15,2,6,0,663,678
75128,15,2,6,0,663,678
78175,14,3,6,0,663,677
88880,34,2,6,0,663,697
89197,34,3,6,0,663,697
112130,15,2,6,0,663,678
6720,14,3,6,0,664,678
9083,26,1,6,0,664,690
9667,14,2,6,0,664,678
9836,14,3,6,0,664,678
13891,57,1,6,1,664,721
24390,14,2,6,0,664,678
33178,36,1,6,0,664,700
40470,14,2,6,0,664,678
40937,14,3,6,0,664,678
44833,36,1,6,0,664,700
45178,14,2,6,0,664,678
55190,23,1,6,0,664,687
73004,36,1,6,0,664,700
78062,14,2,6,0,664,678
79863,14,2,6,0,664,678
80940,60,1,6,1,664,724
85298,36,1,6,0,664,700
89850,14,2,6,0,664,678
98399,14,2,6,0,664,678
108989,36,1,6,0,664,700
118396,36,1,6,0,664,700
11763,21,1,6,0,665,686
14489,10,3,6,0,665,675
17437,14,1,6,0,665,679
20668,29,2,6,0,665,694
24433,32,2,6,0,665,697
25461,15,1,6,0,665,680
46817,13,3,6,0,665,678
61143,32,3,6,0,665,697
64184,13,1,6,0,665,678
83252,32,2,6,0,665,697
92781,10,3,6,0,665,675
93858,21,1,6,0,665,686
99280,32,3,6,0,665,697
102208,32,3,6,0,665,697
105710,32,3,6,0,665,697
118915,10,3,6,0,665,675
122283,32,2,6,0,665,697
126253,23,1,6,0,665,688
127681,21,1,6,0,665,686
18223,16,1,6,0,666,682
22153,31,2,6,0,666,697
42516,29,1,6,0,666,695
49251,8,3,6,0,666,674
71698,8,3,6,0,666,674
74606,3,1,6,0,666,669
82432,8,2,6,0,666,674
101824,8,3,6,0,666,674
114033,11,1,6,0,666,677
14219,30,3,6,0,667,697
15166,30,1,6,0,667,697
18478,30,1,6,0,667,697
20828,30,3,6,0,667,697
21112,30,1,6,0,667,697
34670,30,3,6,0,667,697
36002,30,3,6,0,667,697
40694,30,3,6,0,667,697
41204,30,1,6,0,667,697
43667,30,1,6,0,667,697
47000,30,1,6,0,667,697
48762,30,3,6,0,667,697
60668,30,1,6,0,667,697
62282,30,2,6,0,667,697
64168,30,3,6,0,667,697
68171,30,3,6,0,667,697
87346,30,1,6,0,667,697
92059,30,3,6,0,667,697
96159,30,1,6,0,667,697
98049,30,4,6,0,667,697
99001,30,1,6,0,667,697
108461,30,3,6,0,667,697
125464,30,3,6,0,667,697
42206,16,1,6,0,668,684
124268,16,1,6,0,668,684
115358,16,1,6,0,669,685
18259,15,1,6,0,671,686
37134,11,1,6,0,672,683
41540,40,2,6,0,672,712
9074,34,2,6,0,673,707
24827,37,2,6,0,673,710
69022,37,2,6,0,673,710
72489,34,2,6,0,673,707
77850,37,2,6,0,673,710
82138,22,2,6,0,673,695
97901,28,2,6,0,673,701
108931,37,2,6,0,673,710
7281,15,2,6,0,674,689
8441,15,2,6,0,674,689
10401,15,2,6,0,674,689
10554,15,2,6,0,674,689
10731,15,2,6,0,674,689
11525,15,2,6,0,674,689
16356,26,1,6,0,674,700
17229,15,2,6,0,674,689
18935,15,2,6,0,674,689
19836,15,2,6,0,674,689
20682,15,2,6,0,674,689
20935,15,2,6,0,674,689
22121,15,2,6,0,674,689
25571,15,2,6,0,674,689
30118,15,2,6,0,674,689
38029,15,2,6,0,674,689
38635,15,2,6,0,674,689
38977,27,1,6,0,674,701
38993,15,2,6,0,674,689
44617,25,2,6,0,674,699
49872,15,2,6,0,674,689
49881,15,2,6,0,674,689
50650,23,3,6,0,674,697
51527,15,2,6,0,674,689
53277,15,2,6,0,674,689
54012,15,2,6,0,674,689
56071,15,2,6,0,674,689
57897,15,2,6,0,674,689
58382,33,2,6,0,674,707
63201,15,2,6,0,674,689
65546,15,2,6,0,674,689
69286,15,2,6,0,674,689
69833,15,2,6,0,674,689
70193,15,2,6,0,674,689
71392,15,2,6,0,674,689
73691,15,2,6,0,674,689
74913,15,2,6,0,674,689
75007,15,2,6,0,674,689
76155,16,1,6,0,674,690
81199,15,2,6,0,674,689
81330,15,2,6,0,674,689
82974,15,2,6,0,674,689
83982,15,2,6,0,674,689
90833,15,2,6,0,674,689
91674,15,2,6,0,674,689
98691,15,2,6,0,674,689
101858,15,2,6,0,674,689
102284,15,2,6,0,674,689
114362,15,2,6,0,674,689
119111,15,2,6,0,674,689
120908,15,2,6,0,674,689
122911,15,2,6,0,674,689
122916,15,2,6,0,674,689
123022,15,2,6,0,674,689
124262,15,2,6,0,674,689
125733,31,2,6,0,674,705
127547,15,2,6,0,674,689
9775,35,2,6,0,675,710
10718,39,1,6,0,675,714
19207,32,2,6,0,675,707
33942,20,1,6,0,675,695
40799,17,1,6,0,675,692
55747,21,1,6,0,675,696
118650,20,1,6,0,675,695
121262,108,1,7,0,675,783
8492,31,2,6,0,676,707
9043,31,2,6,0,676,707
12959,25,2,6,0,676,701
17046,48,1,6,1,676,724
19308,31,2,6,0,676,707
24414,20,1,6,0,676,696
53471,26,1,6,0,676,702
63657,31,2,6,0,676,707
126455,31,2,6,0,676,707
46465,18,1,6,0,677,695
112208,15,1,6,0,677,692
123142,23,1,6,1,677,700
125224,7,1,6,0,677,684
6122,29,2,6,0,678,707
24119,14,1,6,0,678,692
33651,17,1,6,0,678,695
34254,29,2,6,0,678,707
36358,29,2,6,0,678,707
37262,29,2,6,0,678,707
39605,29,2,6,0,678,707
46303,18,2,6,0,678,696
52606,17,1,6,0,678,695
54974,23,2,6,0,678,701
63539,29,2,6,0,678,707
73222,29,2,6,0,678,707
78003,9,1,6,0,678,687
82668,9,1,6,0,678,687
104130,14,1,6,0,678,692
105080,29,2,6,0,678,707
5948,12,1,6,0,679,691
11632,22,1,6,0,679,701
24726,21,1,6,0,679,700
40295,18,1,6,0,679,697
40479,8,1,6,0,679,687
55146,8,1,6,0,679,687
70150,18,2,6,1,679,697
70725,18,2,6,1,679,697
71766,8,1,6,0,679,687
71806,8,1,6,0,679,687
91357,15,1,6,0,679,694
95204,21,3,6,0,679,700
102282,19,1,6,0,679,698
112281,17,1,6,0,679,696
15050,19,1,6,0,680,699
49638,12,1,6,0,680,692
56826,11,1,6,1,680,691
57047,12,3,6,0,680,692
69847,20,2,6,0,680,700
93718,10,1,6,0,680,690
118179,12,1,6,0,680,692
126327,18,1,6,0,680,698
17500,12,2,6,0,681,693
49967,14,1,6,0,681,695
51516,11,1,6,0,681,692
58264,11,1,6,0,681,692
63401,12,1,6,0,681,693
71959,14,1,6,0,681,695
74606,15,2,6,0,681,696
77191,10,1,6,0,681,691
82204,15,2,6,0,681,696
93528,12,1,6,0,681,693
95604,11,2,6,0,681,692
100698,11,1,6,0,681,692
109756,13,1,6,0,681,694
111200,13,2,6,0,681,694
111808,15,1,6,0,681,696
123155,11,1,6,0,681,692
9558,15,1,6,0,682,697
24552,12,1,6,0,682,694
46817,15,4,6,0,682,697
58098,9,1,6,0,682,691
63809,14,1,6,0,682,696
81329,12,1,6,0,682,694
90320,21,1,6,0,682,703
91767,11,1,6,0,682,693
102532,10,1,6,0,682,692
111285,15,1,6,0,682,697
42631,4,1,6,0,683,687
52964,4,1,6,0,683,687
53979,4,1,6,0,683,687
70067,4,1,6,0,683,687
90284,12,1,6,0,683,695
107702,17,2,6,0,683,700
85827,7,2,6,0,684,691
108110,7,1,6,0,684,691
119516,8,1,6,0,684,692
124270,24,1,6,1,684,708
128245,8,1,6,0,684,692
21885,16,2,6,0,685,701
40578,31,1,6,1,685,716
51091,16,2,6,0,685,701
106632,16,3,6,0,685,701
10525,4,1,6,0,686,690
36793,20,2,6,0,686,706
44135,4,1,6,0,686,690
46893,4,1,6,0,686,690
105511,15,1,6,0,686,701
17311,2,1,6,0,687,689
25397,10,4,6,0,687,697
32990,7,1,6,0,687,694
78175,10,4,6,0,687,697
96425,13,1,6,1,687,700
94194,15,1,6,0,688,703
99115,13,2,6,0,688,701
113140,19,3,6,0,688,707
6720,8,4,6,0,689,697
9667,8,3,6,0,689,697
9836,8,4,6,0,689,697
14489,8,4,6,0,689,697
23018,8,3,6,0,689,697
24390,8,3,6,0,689,697
24957,8,4,6,0,689,697
31643,8,3,6,0,689,697
36253,8,3,6,0,689,697
40470,8,3,6,0,689,697
40937,8,4,6,0,689,697
43788,14,1,6,0,689,703
44682,14,1,6,0,689,703
45178,8,3,6,0,689,697
47439,8,3,6,0,689,697
64847,8,3,6,0,689,697
75128,8,3,6,0,689,697
92781,8,4,6,0,689,697
98399,8,3,6,0,689,697
112130,8,3,6,0,689,697
118915,8,4,6,0,689,697
121434,23,3,6,0,689,712
123880,14,1,6,0,689,703
12295,9,1,6,0,690,699
78062,6,3,6,0,690,696
87073,9,1,6,0,690,699
128440,9,1,6,0,690,699
17521,19,2,6,0,691,710
28664,12,1,6,0,691,703
40779,19,4,6,0,691,710
66407,8,1,6,0,691,699
76605,10,3,6,0,691,701
125459,9,3,6,0,691,700
105162,11,1,6,0,692,703
107180,7,2,6,0,692,699
125006,7,3,6,0,692,699
12785,3,1,6,0,693,696
26407,3,1,6,0,693,696
37382,17,2,6,0,693,710
56038,16,2,6,0,693,709
67119,8,1,6,0,693,701
69014,3,1,6,0,693,696
102032,16,2,6,0,693,709
111198,3,1,6,0,693,696
112330,34,2,7,1,693,727
125035,17,2,6,0,693,710
127691,6,1,6,0,693,699
114063,17,2,6,0,694,711
122526,5,2,6,0,694,699
6166,16,1,6,0,695,711
9056,16,1,6,0,695,711
45482,16,3,6,0,695,711
63393,4,1,6,0,695,699
129240,12,1,6,0,695,707
8285,16,2,6,0,696,712
18878,16,2,6,0,696,712
40799,15,2,6,0,696,711
51647,14,1,6,0,696,710
63886,14,2,6,0,696,710
66941,12,1,6,0,696,708
75071,15,2,6,0,696,711
79373,12,1,6,0,696,708
82456,12,2,6,0,696,708
83050,11,2,6,0,696,707
88004,14,2,6,0,696,710
102703,15,2,6,0,696,711
5737,13,2,6,0,697,710
5747,14,1,6,0,697,711
10025,30,2,7,1,697,727
15077,26,2,6,1,697,723
17407,13,2,6,0,697,710
47284,10,3,6,0,697,707
49251,10,4,6,0,697,707
63896,13,2,6,0,697,710
67280,13,2,6,0,697,710
69754,10,3,6,0,697,707
71698,10,4,6,0,697,707
76000,13,3,6,0,697,710
82432,10,3,6,0,697,707
82734,14,2,6,0,697,711
90335,14,1,6,0,697,711
90790,13,2,6,0,697,710
90829,13,1,6,0,697,710
100334,13,2,6,0,697,710
101824,10,4,6,0,697,707
106080,13,2,6,0,697,710
110074,13,2,6,0,697,710
111523,13,2,6,0,697,710
13391,11,2,6,0,698,709
17172,11,2,6,0,698,709
17500,11,3,6,0,698,709
22038,12,2,6,0,698,710
32849,12,3,6,0,698,710
38199,12,2,6,0,698,710
56207,11,2,6,0,698,709
57636,12,2,6,0,698,710
67004,11,2,6,0,698,709
67236,11,3,6,0,698,709
72351,10,2,6,0,698,708
79886,9,3,6,0,698,707
85347,29,2,7,1,698,727
103662,11,2,6,0,698,709
112171,9,2,6,0,698,707
117809,11,2,6,0,698,709
123634,12,2,6,0,698,710
8448,8,3,6,0,699,707
12185,8,2,6,0,699,707
20019,10,2,6,0,699,709
74922,12,1,6,1,699,711
78660,10,1,6,0,699,709
80671,10,1,6,0,699,709
81582,10,2,6,0,699,709
82771,8,2,6,0,699,707
83256,9,2,6,0,699,708
89992,9,2,6,0,699,708
97026,9,2,6,0,699,708
111200,9,3,6,0,699,708
116509,9,2,6,0,699,708
121202,9,2,6,0,699,708
6720,7,5,6,0,700,707
6869,7,2,6,0,700,707
7292,7,2,6,0,700,707
12162,7,2,6,0,700,707
12304,7,2,6,0,700,707
13306,27,2,7,1,700,727
16573,7,2,6,0,700,707
17388,7,3,6,0,700,707
18568,7,2,6,0,700,707
18581,7,2,6,0,700,707
20885,7,2,6,0,700,707
22073,7,2,6,0,700,707
24563,7,2,6,0,700,707
26864,7,2,6,0,700,707
34810,7,2,6,0,700,707
35729,7,2,6,0,700,707
37520,7,2,6,0,700,707
39564,7,3,6,0,700,707
40937,7,5,6,0,700,707
45146,7,2,6,0,700,707
45848,7,2,6,0,700,707
48789,7,2,6,0,700,707
50650,7,4,6,0,700,707
52049,7,2,6,0,700,707
52792,27,2,7,1,700,727
53485,6,2,6,0,700,706
56821,7,2,6,0,700,707
57047,7,4,6,0,700,707
59034,8,2,6,0,700,708
61164,7,2,6,0,700,707
63839,7,2,6,0,700,707
63840,7,2,6,0,700,707
65556,27,2,7,1,700,727
65690,7,2,6,0,700,707
65765,7,2,6,0,700,707
66645,7,2,6,0,700,707
67292,7,2,6,0,700,707
69009,7,2,6,0,700,707
71512,7,2,6,0,700,707
73685,7,2,6,0,700,707
78047,7,2,6,0,700,707
81371,7,2,6,0,700,707
82443,7,2,6,0,700,707
82903,7,2,6,0,700,707
84673,7,2,6,0,700,707
84975,7,2,6,0,700,707
85055,7,2,6,0,700,707
85235,7,2,6,0,700,707
85827,7,3,6,0,700,707
86216,7,2,6,0,700,707
86242,7,2,6,0,700,707
91996,7,2,6,0,700,707
93213,7,2,6,0,700,707
96544,7,2,6,0,700,707
100464,7,2,6,0,700,707
102868,7,2,6,0,700,707
102997,7,2,6,0,700,707
104419,7,2,6,0,700,707
105699,7,3,6,0,700,707
110824,7,2,6,0,700,707
111416,7,2,6,0,700,707
111564,7,2,6,0,700,707
112152,7,2,6,0,700,707
112294,7,2,6,0,700,707
114841,7,2,6,0,700,707
119437,8,2,6,0,700,708
119472,7,2,6,0,700,707
119519,7,2,6,0,700,707
120927,7,2,6,0,700,707
121790,7,2,6,0,700,707
123445,7,2,6,0,700,707
125315,7,2,6,0,700,707
125835,60,1,7,0,700,760
126008,7,2,6,0,700,707
9263,5,3,6,0,701,706
21306,5,2,6,0,701,706
22385,5,2,6,0,701,706
26027,5,3,6,0,701,706
26611,6,2,6,0,701,707
31643,5,4,6,0,701,706
33011,6,1,6,0,701,707
35021,5,2,6,0,701,706
35360,5,2,6,0,701,706
43066,5,2,6,0,701,706
62360,5,2,6,0,701,706
63266,6,2,6,0,701,707
63441,5,3,6,0,701,706
66415,5,2,6,0,701,706
71403,5,3,6,0,701,706
82822,6,2,6,0,701,707
87015,5,2,6,0,701,706
91802,5,2,6,0,701,706
102427,5,2,6,0,701,706
103626,5,3,6,0,701,706
107761,6,2,6,0,701,707
110218,5,2,6,0,701,706
116828,5,2,6,0,701,706
117196,5,2,6,0,701,706
125514,5,3,6,0,701,706
40113,2,3,6,0,702,704
40479,4,2,6,0,702,706
43837,4,2,6,0,702,706
55146,4,2,6,0,702,706
56143,2,3,6,0,702,704
61876,4,3,6,0,702,706
71766,4,2,6,0,702,706
71806,4,2,6,0,702,706
88011,4,2,6,0,702,706
97901,2,3,6,0,704,706
88798,16,1,6,1,706,722
116239,18,1,7,1,708,726
96425,27,2,7,1,710,737
98319,14,1,6,1,710,724
29865,12,1,6,1,711,723
102301,12,1,6,1,711,723
99049,6,1,6,1,714,720
82167,5,3,6,1,718,723
112094,5,3,6,1,718,723
65556,110,3,9,1,734,844
107461,32,2,7,0,734,766
9263,27,4,7,0,737,764
14489,26,5,7,0,737,763
24957,39,5,7,0,737,776
26027,27,4,7,0,737,764
40113,26,4,7,0,737,763
45482,27,4,7,0,737,764
46817,28,5,7,0,737,765
47284,69,4,8,0,737,806
48601,26,3,7,0,737,763
48717,26,3,7,0,737,763
49303,26,3,7,0,737,763
56143,26,4,7,0,737,763
57047,26,5,7,0,737,763
61876,27,4,7,0,737,764
63441,28,4,7,0,737,765
67236,27,4,7,0,737,764
69754,69,4,8,0,737,806
72874,26,3,7,0,737,763
78175,26,5,7,0,737,763
81424,26,3,7,0,737,763
89444,26,3,7,0,737,763
91357,157,2,10,1,737,894
92781,26,5,7,0,737,763
95563,26,3,7,0,737,763
98049,26,5,7,0,737,763
101700,26,3,7,0,737,763
103547,33,3,7,0,737,770
103626,27,4,7,0,737,764
112483,26,2,7,0,737,763
118915,26,5,7,0,737,763
121758,26,3,7,0,737,763
125514,27,4,7,0,737,764
79886,6,4,7,0,738,744
24433,11,3,7,0,739,750
29458,11,3,7,0,739,750
83252,11,3,7,0,739,750
122283,11,3,7,0,739,750
24872,12,1,7,0,741,753
81412,13,1,7,0,741,754
100752,11,1,7,0,741,752
34827,10,1,7,0,742,752
81329,10,2,7,0,742,752
105710,7,4,7,0,742,749
11632,7,2,7,0,743,750
11802,9,1,7,0,743,752
65400,9,1,7,0,743,752
66407,41,2,7,0,743,784
78928,9,1,7,0,743,752
83334,7,1,7,0,743,750
92392,9,1,7,0,743,752
102282,10,2,7,0,743,753
109272,9,2,7,0,743,752
126327,9,2,7,0,743,752
26407,7,2,7,0,744,751
62305,3,2,7,0,747,750
79886,15,5,7,0,749,764
20080,29,1,7,1,750,779
37805,14,1,7,0,750,764
45791,25,1,7,0,750,775
74775,14,1,7,0,750,764
90934,14,1,7,0,750,764
49848,59,1,8,1,751,810
75072,20,2,7,0,751,771
96425,70,3,8,1,751,821
112094,148,4,10,1,751,899
64643,11,1,7,0,753,764
129048,48,1,8,1,753,801
12426,77,1,8,1,755,832
8285,29,3,7,0,756,785
57440,31,1,7,0,756,787
118255,12,2,7,0,756,768
55011,17,1,7,0,757,774
56941,29,1,7,0,757,786
102342,33,3,7,1,757,790
23738,27,1,7,0,758,785
29127,27,1,7,0,758,785
29865,106,2,9,1,758,864
34469,27,1,7,0,758,785
41540,23,3,7,0,758,781
47047,27,1,7,0,758,785
48016,27,1,7,0,758,785
52900,62,1,8,1,758,820
76624,35,1,7,1,758,793
76840,27,1,7,0,758,785
87400,27,1,7,0,758,785
102282,26,3,7,0,758,784
127614,27,2,7,0,758,785
5747,23,2,7,0,759,782
11802,25,2,7,0,759,784
15191,26,1,7,0,759,785
27657,26,1,7,0,759,785
36002,26,4,7,0,759,785
40799,27,3,7,0,759,786
49967,41,2,8,0,759,800
65027,26,1,7,0,759,785
71959,19,2,7,0,759,778
74606,13,3,7,0,759,772
78928,25,2,7,0,759,784
94350,26,2,7,0,759,785
104130,27,2,7,0,759,786
6190,24,1,7,0,760,784
10054,20,1,7,0,760,780
11632,30,3,7,0,760,790
17616,19,1,7,0,760,779
22038,24,3,7,0,760,784
35315,20,1,7,0,760,780
60291,19,1,7,0,760,779
64520,38,2,7,1,760,798
67488,45,1,8,0,760,805
81344,25,1,7,0,760,785
81412,32,2,7,0,760,792
83131,44,1,8,0,760,804
87747,20,1,7,0,760,780
93120,20,1,7,0,760,780
100626,21,2,7,0,760,781
102985,20,1,7,0,760,780
114502,24,1,7,0,760,784
118128,27,1,7,0,760,787
119394,7,1,7,0,760,767
10822,21,1,7,0,761,782
17388,18,4,7,0,761,779
26407,24,3,7,0,761,785
32885,19,1,7,0,761,780
44549,17,2,7,0,761,778
55122,19,1,7,0,761,780
61596,21,1,7,0,761,782
63906,25,1,7,0,761,786
66831,21,1,7,0,761,782
69722,19,1,7,0,761,780
70067,21,2,7,0,761,782
84003,21,1,7,0,761,782
86456,21,1,7,0,761,782
87858,22,2,7,0,761,783
111808,56,2,8,0,761,817
120809,21,1,7,0,761,782
126038,22,1,7,0,761,783
127455,19,1,7,0,761,780
5948,22,2,7,0,762,784
16056,20,1,7,0,762,782
16805,20,2,7,0,762,782
37348,18,1,7,0,762,780
38224,18,1,7,0,762,780
46803,70,1,8,0,762,832
53979,20,2,7,0,762,782
68180,20,1,7,0,762,782
77907,23,1,7,0,762,785
83252,19,4,7,0,762,781
102532,20,2,7,0,762,782
105182,20,1,7,0,762,782
112130,20,4,7,0,762,782
122336,20,1,7,0,762,782
9558,19,2,7,0,763,782
22153,51,3,8,0,763,814
24414,17,2,7,0,763,780
24421,13,1,7,0,763,776
38977,13,2,7,0,763,776
40479,19,3,7,0,763,782
45151,13,1,7,0,763,776
54659,20,2,7,0,763,783
55146,19,3,7,0,763,782
65690,13,3,7,0,763,776
71766,19,3,7,0,763,782
71806,19,3,7,0,763,782
72925,13,1,7,0,763,776
90266,13,1,7,0,763,776
92392,46,2,8,0,763,809
94282,7,3,7,0,763,770
105710,19,5,7,0,763,782
111198,9,2,7,0,763,772
111285,21,2,7,0,763,784
111331,15,1,7,1,763,778
111910,13,1,7,0,763,776
114974,15,1,7,1,763,778
118746,7,3,7,0,763,770
121328,13,1,7,0,763,776
126008,17,3,7,0,763,780
126455,19,3,7,0,763,782
6831,13,1,7,0,764,777
9741,12,1,7,0,764,776
12295,18,2,7,0,764,782
21306,13,3,7,0,764,777
22358,13,1,7,0,764,777
24291,15,1,7,0,764,779
34810,13,3,7,0,764,777
37233,13,1,7,0,764,777
42516,5,2,7,0,764,769
48775,22,1,7,1,764,786
59468,12,1,7,0,764,776
65821,42,1,8,1,764,806
67431,13,1,7,0,764,777
68650,13,1,7,0,764,777
71416,13,1,7,0,764,777
72446,13,1,7,0,764,777
77286,7,2,7,0,764,771
86816,13,1,7,0,764,777
87073,18,2,7,0,764,782
87508,22,1,7,0,764,786
91996,12,3,7,0,764,776
93998,19,1,7,0,764,783
102455,16,1,7,0,764,780
103059,13,1,7,0,764,777
104419,13,3,7,0,764,777
115048,12,1,7,0,764,776
121025,12,1,7,0,764,776
121622,13,1,7,0,764,777
123308,10,2,7,0,764,774
125611,15,1,7,0,764,779
128440,18,2,7,0,764,782
8735,17,1,7,0,765,782
32990,16,2,7,0,765,781
33806,41,2,8,0,765,806
39962,17,1,7,0,765,782
43949,11,1,7,0,765,776
45483,17,1,7,0,765,782
50650,14,5,7,0,765,779
61033,61,1,8,1,765,826
77397,11,1,7,0,765,776
109756,17,2,7,0,765,782
109762,17,1,7,0,765,782
112208,11,2,7,0,765,776
115067,44,1,8,0,765,809
11623,47,1,8,1,766,813
16237,14,1,7,0,766,780
37842,14,1,7,0,766,780
41202,18,1,7,0,766,784
42631,10,2,7,0,766,776
51329,16,1,7,0,766,782
51516,16,2,7,0,766,782
52597,16,1,7,0,766,782
52964,10,2,7,0,766,776
55397,31,2,7,1,766,797
68495,15,1,7,0,766,781
82204,3,3,7,0,766,769
94941,11,3,7,0,766,777
106857,115,1,10,0,766,881
122261,26,1,7,0,766,792
126348,30,1,7,0,766,796
128612,16,1,7,0,766,782
8448,10,4,7,0,767,777
8492,9,3,7,0,767,776
9836,26,5,7,0,767,793
10138,8,1,7,0,767,775
16573,9,3,7,0,767,776
17046,7,2,7,1,767,774
17500,60,4,8,0,767,827
17867,39,1,8,0,767,806
18935,9,3,7,0,767,776
20879,8,1,7,0,767,775
41294,9,1,7,0,767,776
43664,9,1,7,0,767,776
49192,27,1,7,0,767,794
55139,7,1,7,0,767,774
76395,7,1,7,1,767,774
82650,9,1,7,0,767,776
85347,8,3,7,0,767,775
102997,9,3,7,0,767,776
106668,9,1,7,0,767,776
112620,10,1,7,0,767,777
112820,13,1,7,0,767,780
7281,3,3,7,0,768,771
18820,8,1,7,0,768,776
39053,5,1,7,1,768,773
46658,11,1,7,0,768,779
76015,8,1,7,0,768,776
80597,31,1,7,1,768,799
92991,12,1,7,1,768,780
106396,8,1,7,0,768,776
110032,38,1,8,0,768,806
115358,18,2,7,0,768,786
117218,41,1,8,1,768,809
127062,5,2,7,1,768,773
17290,39,1,8,1,769,808
40311,56,1,8,1,769,825
59139,42,1,8,1,769,811
62694,39,1,8,1,769,808
69250,13,1,7,0,769,782
97644,31,1,8,1,769,800
115214,28,2,7,0,769,797
124042,28,1,7,1,769,797
28764,4,1,7,0,770,774
51415,6,1,7,0,770,776
66009,12,1,7,0,770,782
45607,30,1,8,1,771,801
90336,29,1,8,1,771,800
98317,40,1,8,0,771,811
13763,25,1,7,0,772,797
69301,17,2,7,1,772,789
21255,14,1,7,0,773,787
60721,26,1,7,1,773,799
67187,48,1,8,1,773,821
71812,33,1,8,0,773,806
75442,18,1,7,0,773,791
83289,55,1,8,1,773,828
100752,19,2,7,0,773,792
109552,33,1,8,0,773,806
118255,19,3,7,1,773,792
28125,14,1,7,0,774,788
60593,21,1,7,0,774,795
74952,14,1,7,0,774,788
81398,14,1,7,0,774,788
90320,9,2,7,0,774,783
24119,2,2,7,0,775,777
24552,108,2,10,0,775,883
51116,31,1,8,0,775,806
71522,31,1,8,1,775,806
74922,10,2,7,1,775,785
94194,11,2,7,0,775,786
104453,8,1,7,0,775,783
65400,7,2,7,0,776,783
110466,19,1,7,0,776,795
33178,4,2,7,0,777,781
40936,6,1,7,1,777,783
44833,4,2,7,0,777,781
46817,11,6,7,0,777,788
62094,8,1,7,0,777,785
73004,4,2,7,0,777,781
84695,18,1,7,1,777,795
85298,4,2,7,0,777,781
101858,8,3,7,0,777,785
107461,6,3,7,0,777,783
108989,4,2,7,0,777,781
115136,29,1,8,0,777,806
118396,4,2,7,0,777,781
125600,8,1,7,0,777,785
128914,29,1,8,0,777,806
61073,37,1,8,1,778,815
110824,33,3,8,0,778,811
116239,35,2,8,1,778,813
14489,6,6,7,0,779,785
68715,6,1,7,0,779,785
69014,6,2,7,0,779,785
86936,4,1,7,0,779,783
92781,6,6,7,0,779,785
111101,14,1,7,0,779,793
111662,12,1,7,0,779,791
118915,6,6,7,0,779,785
34827,14,2,7,0,780,794
73513,4,1,7,0,780,784
81329,13,3,7,0,780,793
96477,30,1,8,1,780,810
98319,32,2,8,1,780,812
102301,32,2,8,1,780,812
115113,13,1,7,1,780,793
40295,18,2,7,0,781,799
109272,9,3,7,0,781,790
112483,10,3,7,0,781,791
14615,7,1,7,0,782,789
37487,28,2,8,1,782,810
70532,15,1,7,0,782,797
24872,38,2,8,0,783,821
33457,21,1,8,1,783,804
57867,6,1,7,1,783,789
95397,20,1,8,1,783,803
123308,28,3,8,0,783,811
9365,42,1,8,1,784,826
37215,6,1,7,0,784,790
58175,48,3,8,1,784,832
63910,25,1,8,1,784,809
71567,35,2,8,1,784,819
126413,6,1,7,0,784,790
129534,6,1,7,0,784,790
48244,4,1,7,0,785,789
76395,24,2,8,1,785,809
44121,4,1,7,0,786,790
115048,8,2,7,0,786,794
41540,23,4,8,0,787,810
76015,17,2,8,0,789,806
93874,14,1,8,1,789,803
82167,109,4,10,1,790,899
84499,11,1,8,1,790,801
111302,20,1,8,0,791,811
7557,37,1,8,1,792,829
8448,14,5,8,0,792,806
24401,6,1,7,0,792,798
24957,22,6,8,0,792,814
32885,57,2,9,0,792,849
46817,24,7,8,0,792,816
51516,25,3,8,0,792,817
70067,17,3,8,0,792,809
78175,22,6,8,0,792,814
100626,9,3,8,0,792,801
14489,21,7,8,0,793,814
16744,34,1,8,1,793,827
36877,45,2,8,0,793,838
59319,13,1,8,0,793,806
66009,43,2,8,0,793,836
92781,21,7,8,0,793,814
118915,21,7,8,0,793,814
20080,102,2,10,1,794,896
24433,12,4,8,0,794,806
29458,12,4,8,0,794,806
44833,15,3,8,0,794,809
45791,90,2,10,0,794,884
52428,39,1,8,0,794,833
54012,39,3,8,0,794,833
55122,15,2,8,0,794,809
58736,39,1,8,0,794,833
60001,39,1,8,0,794,833
69722,15,2,8,0,794,809
75829,39,1,8,0,794,833
77397,12,2,8,0,794,806
83252,12,5,8,0,794,806
99280,39,4,8,0,794,833
102868,55,3,9,0,794,849
105095,12,1,8,0,794,806
118164,25,1,8,0,794,819
122283,12,4,8,0,794,806
128062,23,1,8,0,794,817
34810,12,4,8,0,795,807
40799,10,4,8,0,795,805
62282,11,3,8,0,795,806
67236,89,5,10,0,795,884
86816,12,2,8,0,795,807
104419,12,4,8,0,795,807
106622,9,1,8,0,795,804
119516,21,2,8,0,795,816
121622,12,2,8,0,795,807
6831,11,2,8,0,796,807
21157,21,1,8,0,796,817
21306,11,4,8,0,796,807
31569,74,1,9,0,796,870
37233,11,2,8,0,796,807
46658,11,2,8,0,796,807
50650,8,6,8,0,796,804
67431,11,2,8,0,796,807
69201,74,1,9,0,796,870
71416,11,2,8,0,796,807
72446,11,2,8,0,796,807
82648,74,1,9,0,796,870
82771,10,3,8,0,796,806
86936,13,2,8,0,796,809
87211,74,1,9,0,796,870
100221,34,2,8,0,796,830
111285,10,3,8,0,796,806
126774,15,1,8,0,796,811
14991,9,1,8,0,797,806
17046,33,3,8,1,797,830
34887,20,1,8,0,797,817
44985,14,1,8,0,797,811
68495,19,2,8,0,797,816
68840,18,4,8,0,797,815
81956,14,1,8,0,797,811
85347,30,4,8,1,797,827
89992,20,3,8,0,797,817
95428,13,1,8,0,797,810
107180,40,3,8,0,797,837
112609,30,1,8,1,797,827
116444,24,1,8,0,797,821
116579,25,1,8,0,797,822
119111,20,3,8,0,797,817
125006,22,4,8,0,797,819
128798,15,1,8,0,797,812
8492,8,4,8,0,798,806
55747,8,2,8,0,798,806
64940,8,1,8,0,798,806
97953,19,3,8,0,798,817
102342,31,4,8,1,798,829
105710,7,6,8,0,798,805
125459,19,4,8,0,798,817
126659,13,1,8,0,798,811
16237,5,2,8,0,799,804
93998,7,2,8,0,799,806
109762,7,2,8,0,799,806
32990,3,3,8,0,801,804
79863,15,3,8,0,801,816
89850,15,3,8,0,801,816
107461,18,4,8,0,801,819
31279,15,1,8,0,803,818
39053,27,2,8,1,803,830
67214,35,1,8,0,803,838
111225,82,1,10,0,803,885
115048,18,3,8,0,803,821
119004,35,1,8,0,803,838
38193,32,1,8,0,805,837
38934,69,1,9,0,805,874
9588,8,1,8,0,806,814
22432,31,1,8,0,806,837
23823,29,1,8,0,806,835
37348,9,2,8,0,806,815
40643,29,1,8,0,806,835
41015,29,1,8,0,806,835
52648,29,1,8,0,806,835
54840,52,1,9,0,806,858
66825,29,1,8,0,806,835
70150,33,3,8,1,806,839
70725,96,3,10,1,806,902
77363,8,1,8,0,806,814
80811,29,1,8,0,806,835
88232,29,3,8,0,806,835
91526,29,1,8,0,806,835
100550,29,1,8,0,806,835
105817,8,1,8,0,806,814
106354,29,1,8,0,806,835
107790,29,1,8,0,806,835
109608,29,1,8,0,806,835
110061,29,1,8,0,806,835
115217,29,1,8,0,806,835
122130,8,1,8,0,806,814
125254,29,1,8,0,806,835
126944,29,1,8,0,806,835
26027,10,5,8,0,807,817
48717,6,4,8,0,807,813
61876,10,5,8,0,807,817
64643,79,2,10,0,807,886
75072,10,3,8,0,807,817
80691,8,1,8,0,807,815
95563,6,4,8,0,807,813
103547,10,4,8,0,807,817
123142,36,2,9,1,807,843
9324,63,1,9,0,808,871
27903,63,1,9,0,808,871
27936,63,1,9,0,808,871
37164,63,1,9,0,808,871
40659,63,1,9,0,808,871
41289,63,1,9,0,808,871
43640,63,1,9,0,808,871
54100,63,1,9,0,808,871
57359,63,1,9,0,808,871
57663,63,1,9,0,808,871
78639,63,1,9,0,808,871
115499,63,1,9,0,808,871
118838,13,1,8,0,808,821
123170,63,1,9,0,808,871
26072,29,2,8,0,809,838
69301,20,3,8,1,809,829
81344,11,2,8,0,809,820
92433,14,1,8,0,809,823
121758,3,4,8,0,809,812
9558,24,3,8,0,810,834
56336,6,1,8,0,810,816
67263,5,1,8,1,811,816
37134,73,2,10,1,812,885
83238,25,1,8,0,812,837
87508,22,2,8,0,812,834
106350,22,1,8,0,812,834
14210,64,1,9,0,813,877
15269,64,1,9,0,813,877
43788,25,2,8,0,813,838
105182,21,2,8,0,813,834
112820,7,2,8,0,813,820
115842,64,1,9,0,813,877
11632,4,4,8,0,814,818
11802,4,3,8,0,814,818
34429,79,1,10,1,814,893
65400,4,3,8,0,814,818
70536,17,2,8,0,814,831
78928,4,3,8,0,814,818
102282,4,4,8,0,814,818
123308,17,4,8,0,814,831
127683,4,1,8,0,814,818
37627,19,1,8,0,815,834
49192,12,2,8,1,815,827
79114,19,1,8,0,815,834
114057,3,1,8,0,815,818
115180,22,1,8,0,815,837
55397,7,3,8,1,816,823
65711,21,2,8,0,816,837
121434,14,4,8,0,816,830
16026,60,1,9,0,817,877
13767,18,2,8,0,818,836
34234,12,2,8,1,818,830
41851,19,1,8,0,818,837
47284,9,5,8,0,818,827
49251,9,5,8,0,818,827
69754,9,5,8,0,818,827
82432,9,4,8,0,818,827
87015,16,3,8,0,818,834
106824,16,1,8,0,818,834
115381,16,1,8,0,818,834
119122,54,1,9,1,818,872
35923,14,1,8,0,820,834
5553,85,1,10,1,822,907
12517,11,1,8,0,823,834
20346,15,1,8,0,823,838
73283,15,1,8,0,823,838
114057,11,2,8,0,823,834
124510,11,1,8,0,823,834
127455,11,2,8,0,823,834
23226,14,1,8,0,824,838
31279,14,2,8,0,824,838
56336,14,2,8,0,824,838
67321,12,3,8,0,825,837
80673,39,1,9,0,825,864
81378,10,1,8,0,825,835
100536,56,1,10,0,825,881
105817,12,2,8,0,825,837
112820,9,3,8,0,825,834
122130,12,2,8,0,825,837
127683,58,2,10,0,825,883
6118,10,1,8,0,826,836
76000,10,4,8,0,826,836
83546,10,1,8,0,826,836
99049,35,2,9,1,826,861
115803,9,1,8,0,826,835
117101,8,1,8,0,826,834
20009,72,1,10,1,827,899
74922,72,3,10,1,827,899
76461,34,1,9,0,827,861
9667,6,4,8,0,828,834
9806,12,1,9,0,828,840
11639,6,1,8,0,828,834
16088,34,1,9,0,828,862
26222,34,1,9,0,828,862
32980,6,1,8,0,828,834
78543,6,1,8,0,828,834
80691,50,2,9,0,828,878
109687,34,1,9,0,828,862
118255,12,4,9,0,828,840
126036,33,1,9,0,828,861
65765,4,3,8,0,829,833
71840,4,1,8,0,829,833
104453,8,2,8,0,829,837
106078,8,1,8,0,829,837
23771,2,1,8,0,830,832
45168,2,1,8,0,830,832
107517,8,1,8,0,830,838
122427,46,1,9,0,831,877
126019,37,1,9,0,831,868
61033,9,2,9,1,832,841
112330,42,3,9,1,832,874
16743,37,1,9,0,833,870
34700,37,1,9,0,833,870
64520,66,3,10,1,833,899
75072,66,4,10,0,833,899
96211,37,1,9,0,833,870
63441,50,5,10,0,834,884
84695,34,2,9,1,834,868
26027,21,6,9,0,835,856
30549,40,1,9,1,835,875
33457,6,2,9,1,835,841
40113,14,5,9,0,835,849
46817,14,8,9,0,835,849
48601,14,4,9,0,835,849
49303,14,4,9,0,835,849
56143,14,5,9,0,835,849
57047,14,6,9,0,835,849
61876,21,6,9,0,835,856
69301,64,4,10,1,835,899
72874,14,4,9,0,835,849
79886,46,6,10,0,835,881
81424,14,4,9,0,835,849
89444,14,4,9,0,835,849
98049,14,6,9,0,835,849
101700,14,4,9,0,835,849
103547,46,5,10,0,835,881
107702,14,3,9,0,835,849
112171,43,3,9,0,835,878
112483,14,4,9,0,835,849
9464,45,1,10,1,836,881
14489,13,8,9,0,836,849
92781,13,8,9,0,836,849
118915,13,8,9,0,836,849
121758,13,5,9,0,836,849
57867,66,2,10,1,838,904
21986,27,1,9,0,839,866
12426,72,2,10,1,840,912
100783,3,1,9,1,840,843
107461,9,5,9,0,840,849
7557,41,2,10,1,841,882
117508,38,1,10,1,842,880
40311,30,2,9,1,843,873
96416,30,1,9,1,843,873
96425,66,4,10,1,843,909
102342,68,5,10,1,843,911
16744,32,2,9,1,844,876
48775,55,2,10,1,844,899
52900,64,2,10,1,844,908
11623,54,2,10,1,845,899
61073,26,2,9,1,845,871
80116,28,1,9,1,845,873
111331,72,2,10,1,845,917
114974,72,2,10,1,845,917
128797,26,1,9,1,845,871
48760,60,1,10,1,846,906
49967,13,3,9,0,846,859
84046,24,1,9,1,846,870
23630,15,1,9,0,847,862
23738,18,2,9,0,847,865
34469,18,2,9,0,847,865
56336,9,3,9,0,847,856
71567,22,3,9,1,847,869
116239,41,3,10,1,847,888
119394,16,2,9,0,847,863
11632,13,5,9,0,848,861
11802,7,4,9,0,848,855
17890,20,2,9,1,848,868
18209,56,2,10,1,848,904
53050,20,1,9,1,848,868
65400,51,4,10,0,848,899
78928,7,4,9,0,848,855
81344,11,3,9,0,848,859
98319,39,3,10,1,848,887
102282,7,5,9,0,848,855
127614,11,3,9,0,848,859
13767,6,3,9,0,849,855
22153,19,4,9,0,849,868
25364,7,1,9,0,849,856
45607,43,2,10,1,849,892
49124,7,1,9,0,849,856
76624,18,2,9,1,849,867
94538,40,1,10,1,849,889
102301,37,3,10,1,849,886
129222,37,1,10,1,849,886
23226,26,2,9,0,850,876
24401,24,2,9,0,850,874
31279,25,3,9,0,850,875
45125,16,1,9,1,850,866
45203,16,1,9,1,850,866
49831,16,1,9,1,850,866
57809,16,2,9,1,850,866
62528,16,1,9,1,850,866
67187,16,2,9,1,850,866
80043,16,1,9,1,850,866
96477,16,2,9,1,850,866
97405,16,1,9,1,850,866
105182,12,3,9,0,850,862
123308,40,5,10,0,850,890
15962,10,1,9,0,851,861
40936,55,2,10,1,851,906
46803,38,2,10,0,851,889
53397,36,1,10,1,851,887
67636,29,1,10,1,851,880
80545,42,1,10,0,851,893
99944,23,1,9,0,851,874
108119,33,1,10,1,851,884
114063,16,3,9,0,851,867
121313,23,1,9,0,851,874
127455,8,3,9,0,851,859
13285,55,2,10,1,852,907
15644,12,1,9,1,852,864
17046,47,4,10,1,852,899
39053,31,3,10,1,852,883
39605,26,3,9,1,852,878
42485,36,1,10,0,852,888
89124,12,1,9,1,852,864
112820,44,4,10,0,852,896
127062,31,3,10,1,852,883
6461,51,1,10,1,853,904
22347,24,1,9,0,853,877
49064,10,1,9,1,853,863
61033,51,3,10,1,853,904
70150,35,4,10,1,853,888
82204,13,4,9,0,853,866
9667,24,5,9,0,854,878
11639,24,2,9,0,854,878
16930,8,1,9,1,854,862
33651,8,2,9,0,854,862
51116,24,2,9,0,854,878
51415,35,2,10,0,854,889
67214,28,2,10,0,854,882
68840,30,5,10,0,854,884
70536,26,3,10,0,854,880
76880,19,1,9,0,854,873
82456,11,3,9,0,854,865
91774,26,1,10,1,854,880
95397,26,2,10,1,854,880
110032,30,2,10,0,854,884
119004,28,2,10,0,854,882
46877,15,1,9,0,855,870
55397,43,4,10,1,855,898
63790,48,1,10,1,855,903
65556,44,4,10,1,855,899
71840,23,2,9,0,855,878
85308,15,1,9,0,855,870
87035,6,1,9,1,855,861
107180,33,4,10,0,855,888
120956,6,1,9,1,855,861
33457,48,3,10,1,856,904
58320,23,1,9,1,856,879
65475,13,1,9,0,856,869
69250,40,2,10,0,856,896
77785,23,1,9,1,856,879
90476,13,1,9,0,856,869
115166,23,1,9,1,856,879
115617,23,1,9,1,856,879
123058,24,1,10,1,856,880
9169,4,1,9,0,857,861
13611,13,1,9,0,857,870
31970,2,1,9,1,857,859
33806,2,3,9,1,857,859
49854,22,1,9,1,857,879
67661,2,1,9,1,857,859
69689,8,1,9,0,857,865
90336,30,2,10,1,857,887
92991,55,2,10,1,857,912
120982,38,1,10,1,857,895
7372,42,1,10,0,858,900
12918,28,1,10,0,858,886
14368,41,1,10,1,858,899
14615,41,2,10,0,858,899
14867,28,1,10,0,858,886
28444,28,1,10,0,858,886
53479,9,1,9,0,858,867
58143,9,1,9,0,858,867
65719,20,1,9,0,858,878
70596,28,1,10,0,858,886
76745,28,1,10,0,858,886
82936,41,1,10,1,858,899
84499,19,2,9,1,858,877
85915,9,1,9,0,858,867
89699,28,1,10,0,858,886
92391,28,1,10,0,858,886
95204,20,4,9,0,858,878
97026,41,3,10,1,858,899
102275,9,1,9,0,858,867
102863,28,1,10,0,858,886
123836,28,1,10,0,858,886
18805,18,1,9,1,859,877
28954,9,1,9,0,859,868
47342,61,1,11,1,859,920
83238,22,2,10,0,859,881
97055,9,1,9,0,859,868
10472,11,1,9,0,860,871
13044,11,1,9,0,860,871
13140,11,1,9,0,860,871
13287,11,1,9,0,860,871
14515,11,1,9,0,860,871
18878,23,3,10,0,860,883
22276,11,1,9,0,860,871
24334,11,1,9,0,860,871
26411,11,1,9,0,860,871
26842,24,1,10,0,860,884
31082,11,1,9,0,860,871
32849,23,4,10,0,860,883
34234,27,3,10,1,860,887
37215,22,2,10,0,860,882
41241,39,1,10,0,860,899
42845,11,1,9,0,860,871
44475,24,1,10,0,860,884
47030,11,1,9,0,860,871
50185,11,1,9,0,860,871
65710,11,1,9,0,860,871
66725,11,1,9,0,860,871
77286,7,3,9,0,860,867
79138,11,1,9,0,860,871
87508,36,3,10,0,860,896
90146,11,1,9,0,860,871
90880,11,1,9,0,860,871
97241,11,1,9,0,860,871
102284,11,3,9,0,860,871
103433,11,1,9,0,860,871
107461,27,6,10,0,860,887
110319,11,1,9,0,860,871
111302,21,2,10,0,860,881
112483,24,5,10,0,860,884
115214,23,3,10,0,860,883
124934,11,1,9,0,860,871
129534,22,2,10,0,860,882
6166,21,2,10,0,861,882
17588,21,1,10,0,861,882
21306,35,5,10,0,861,896
29078,35,1,10,0,861,896
38091,21,1,10,0,861,882
49192,14,3,9,1,861,875
66776,21,1,10,0,861,882
67321,20,4,10,0,861,881
81412,27,3,10,0,861,888
82512,35,1,10,0,861,896
107152,14,1,9,0,861,875
127468,5,1,9,0,861,866
14533,31,2,10,1,862,893
15077,19,3,10,0,862,881
15089,12,1,9,1,862,874
17521,19,3,10,0,862,881
21255,11,2,9,0,862,873
25216,19,1,10,0,862,881
26027,22,7,10,0,862,884
32243,12,1,9,1,862,874
33843,16,2,9,0,862,878
36877,12,3,9,0,862,874
38193,19,2,10,0,862,881
50121,34,1,10,0,862,896
51329,21,2,10,0,862,883
52597,21,2,10,0,862,883
61876,19,7,10,0,862,881
63886,19,3,10,0,862,881
65711,19,3,10,0,862,881
70918,27,1,10,0,862,889
78543,16,2,9,0,862,878
82734,3,3,9,0,862,865
88004,19,3,10,0,862,881
88383,12,1,9,1,862,874
89948,37,1,10,1,862,899
90829,19,2,10,0,862,881
93495,10,1,9,0,862,872
93998,21,3,10,0,862,883
94736,19,1,10,0,862,881
96162,19,1,10,0,862,881
98317,19,2,10,0,862,881
113278,10,1,9,0,862,872
115048,3,4,9,0,862,865
115113,12,2,9,1,862,874
118866,18,1,10,0,862,880
120913,5,1,9,0,862,867
122261,3,2,9,0,862,865
125269,19,1,10,0,862,881
128612,21,2,10,0,862,883
9263,21,5,10,0,863,884
11435,18,1,10,0,863,881
14489,18,9,10,0,863,881
17500,17,5,10,0,863,880
24433,15,5,9,0,863,878
24957,18,7,10,0,863,881
26883,15,2,9,0,863,878
29458,15,5,9,0,863,878
31455,19,1,10,0,863,882
32885,18,3,10,0,863,881
33203,8,1,9,1,863,871
34009,18,1,10,0,863,881
37627,15,2,9,0,863,878
40113,17,6,10,0,863,880
40937,15,6,9,0,863,878
41388,17,1,10,0,863,880
44985,18,2,10,0,863,881
45482,21,5,10,0,863,884
46817,18,9,10,0,863,881
47284,21,6,10,0,863,884
48601,18,5,10,0,863,881
48717,21,5,10,0,863,884
49303,18,5,10,0,863,881
56143,17,6,10,0,863,880
56295,18,1,10,0,863,881
57047,17,7,10,0,863,880
59319,18,2,10,0,863,881
63253,18,1,10,0,863,881
69754,21,6,10,0,863,884
72874,18,5,10,0,863,881
77634,17,1,10,0,863,880
78175,18,7,10,0,863,881
79114,15,2,9,0,863,878
80671,15,2,9,0,863,878
81424,18,5,10,0,863,881
81956,18,2,10,0,863,881
82650,33,2,10,0,863,896
83252,15,6,9,0,863,878
89444,18,5,10,0,863,881
92781,18,9,10,0,863,881
92827,18,1,10,0,863,881
94956,18,1,10,0,863,881
95563,21,5,10,0,863,884
97889,9,1,9,0,863,872
98049,18,7,10,0,863,881
100221,15,3,9,0,863,878
100783,37,2,10,1,863,900
101467,18,1,10,0,863,881
101700,18,5,10,0,863,881
103626,21,5,10,0,863,884
103773,18,1,10,0,863,881
104236,18,1,10,0,863,881
107702,15,4,9,0,863,878
110824,17,4,10,0,863,880
117101,15,2,9,0,863,878
118915,18,9,10,0,863,881
121758,21,6,10,0,863,884
122283,15,5,9,0,863,878
123634,18,3,10,0,863,881
125514,21,5,10,0,863,884
126659,18,2,10,0,863,881
126774,18,2,10,0,863,881
32980,14,2,9,0,864,878
38199,17,3,10,0,864,881
41494,7,1,9,0,864,871
54659,25,3,10,0,864,889
57636,17,3,10,0,864,881
71054,7,1,9,0,864,871
105187,13,1,9,0,864,877
106589,16,1,10,0,864,880
9558,13,4,9,0,865,878
11955,13,1,9,0,865,878
12517,13,2,9,0,865,878
13767,13,4,9,0,865,878
14552,13,1,9,0,865,878
18568,13,3,9,0,865,878
19477,13,1,9,0,865,878
22073,14,3,9,0,865,879
22285,13,1,9,0,865,878
22385,13,3,9,0,865,878
25306,13,1,9,0,865,878
26611,13,3,9,0,865,878
26623,13,1,9,0,865,878
30168,14,1,9,0,865,879
31643,13,5,9,0,865,878
31736,13,1,9,0,865,878
33011,13,2,9,0,865,878
34887,10,2,9,0,865,875
35458,11,1,9,0,865,876
35704,15,1,10,0,865,880
36643,13,1,9,0,865,878
43066,13,3,9,0,865,878
43837,13,3,9,0,865,878
52428,13,2,9,0,865,878
54012,13,4,9,0,865,878
58736,13,2,9,0,865,878
60001,13,2,9,0,865,878
61729,13,2,9,0,865,878
62360,15,3,10,0,865,880
63266,14,3,9,0,865,879
66009,16,3,10,0,865,881
69465,13,1,9,0,865,878
71604,13,1,9,0,865,878
72270,13,1,9,0,865,878
74419,16,2,10,0,865,881
74697,13,2,9,0,865,878
75829,13,2,9,0,865,878
78167,12,1,9,0,865,877
80610,13,1,9,0,865,878
83256,14,3,9,0,865,879
84161,13,1,9,0,865,878
84382,13,1,9,0,865,878
86816,13,3,9,0,865,878
87816,14,1,9,0,865,879
88011,13,3,9,0,865,878
89992,14,4,9,0,865,879
91802,15,3,10,0,865,880
91996,13,4,9,0,865,878
94941,13,4,9,0,865,878
96464,13,1,9,0,865,878
96684,33,1,10,1,865,898
97042,13,1,9,0,865,878
97444,13,1,9,0,865,878
97660,13,1,9,0,865,878
99280,13,5,9,0,865,878
99286,13,1,9,0,865,878
101716,13,1,9,0,865,878
102427,13,3,9,0,865,878
102703,17,3,10,0,865,882
102997,13,4,9,0,865,878
105378,13,1,9,0,865,878
106396,12,2,9,0,865,877
107151,16,1,10,0,865,881
107761,14,3,9,0,865,879
115381,13,2,9,0,865,878
117196,13,3,9,0,865,878
119111,10,4,9,0,865,875
124111,7,1,9,0,865,872
124193,6,1,9,0,865,871
124644,13,1,9,0,865,878
8252,12,1,9,0,866,878
22432,15,2,10,0,866,881
28445,3,1,9,0,866,869
59034,13,3,9,0,866,879
83289,27,2,10,1,866,893
97397,14,1,10,0,866,880
105817,15,3,10,0,866,881
106350,4,2,9,0,866,870
111198,33,3,10,0,866,899
113803,12,1,9,0,866,878
115180,15,2,10,0,866,881
119437,13,3,9,0,866,879
121622,13,3,9,0,866,879
122130,15,3,10,0,866,881
12185,11,3,9,0,867,878
17172,11,3,9,0,867,878
23823,12,2,9,0,867,879
40643,12,2,9,0,867,879
41015,12,2,9,0,867,879
52648,12,2,9,0,867,879
66825,12,2,9,0,867,879
80811,12,2,9,0,867,879
88232,12,4,9,0,867,879
91526,12,2,9,0,867,879
100550,12,2,9,0,867,879
106354,12,2,9,0,867,879
107790,12,2,9,0,867,879
109608,12,2,9,0,867,879
110061,12,2,9,0,867,879
115217,12,2,9,0,867,879
123137,16,1,10,0,867,883
125254,12,2,9,0,867,879
126944,12,2,9,0,867,879
67280,13,3,10,0,868,881
71403,10,4,9,0,868,878
111200,11,4,9,0,868,879
111523,13,3,10,0,868,881
116509,11,3,9,0,868,879
121202,11,3,9,0,868,879
121434,15,5,10,0,868,883
15050,12,2,10,0,869,881
37382,12,3,10,0,869,881
72351,11,3,10,0,869,880
80940,35,2,10,1,869,904
117809,13,3,10,0,869,882
12785,9,2,9,0,870,879
51300,11,1,10,0,870,881
58822,10,1,10,0,870,880
106824,8,2,9,0,870,878
35360,7,3,9,0,871,878
65765,7,4,9,0,871,878
87015,7,4,9,0,871,878
102868,7,4,9,0,871,878
116828,7,3,9,0,871,878
20019,5,3,9,0,872,877
52259,7,1,9,0,872,879
69009,6,3,9,0,872,878
82771,16,4,10,0,872,888
89966,6,1,9,0,872,878
13391,5,3,9,0,873,878
26026,4,1,9,0,873,877
28657,4,1,9,0,873,877
42206,4,2,9,0,873,877
49251,4,6,9,0,873,877
71698,4,5,9,0,873,877
82432,4,5,9,0,873,877
83050,4,3,9,0,873,877
101824,4,5,9,0,873,877
37842,8,2,10,0,874,882
45162,31,1,10,1,874,905
65829,20,1,10,1,874,894
78928,12,5,10,0,874,886
115358,12,3,10,0,874,886
11802,11,5,10,0,875,886
59139,21,2,10,1,875,896
10472,7,2,10,0,876,883
13044,7,2,10,0,876,883
13140,7,2,10,0,876,883
13287,7,2,10,0,876,883
14515,7,2,10,0,876,883
22276,7,2,10,0,876,883
24334,7,2,10,0,876,883
26411,7,2,10,0,876,883
31082,7,2,10,0,876,883
42845,7,2,10,0,876,883
47030,7,2,10,0,876,883
50185,7,2,10,0,876,883
65710,7,2,10,0,876,883
66725,7,2,10,0,876,883
79138,7,2,10,0,876,883
90146,7,2,10,0,876,883
90880,7,2,10,0,876,883
96477,24,3,10,1,876,900
97241,7,2,10,0,876,883
102284,7,4,10,0,876,883
103433,7,2,10,0,876,883
110319,7,2,10,0,876,883
124934,7,2,10,0,876,883
49192,22,4,10,1,877,899
119394,16,3,10,0,877,893
6190,14,2,10,0,878,892
23738,14,3,10,0,878,892
34469,14,3,10,0,878,892
57928,15,1,10,1,878,893
88798,15,2,10,1,878,893
22714,11,1,10,0,879,890
66407,8,3,10,0,879,887
99049,18,3,10,1,879,897
109762,10,3,10,0,879,889
8448,3,6,10,0,880,883
45203,14,2,10,1,880,894
76253,9,1,10,0,880,889
81344,9,4,10,0,880,889
9169,9,2,10,0,881,890
26407,4,4,10,0,881,885
102282,4,6,10,0,881,885
127614,4,4,10,0,881,885
80597,5,2,10,1,883,888
72789,18,1,10,0,884,902
45125,12,2,10,1,887,899
52803,4,1,10,0,887,891
31455,8,2,10,0,888,896
100536,10,2,10,0,888,898
37215,7,3,10,0,889,896
97055,11,2,10,0,889,900
129534,7,3,10,0,889,896
11435,5,2,10,0,890,895
15077,5,4,10,0,890,895
32885,5,4,10,0,890,895
56295,5,2,10,0,890,895
63253,5,2,10,0,890,895
94956,5,2,10,0,890,895
101467,5,2,10,0,890,895
104236,5,2,10,0,890,895
39053,24,4,10,1,891,915
79886,3,7,10,0,891,894
39605,43,4,11,1,909,952
33457,46,4,11,1,914,960
46416,15,1,11,0,914,929
124042,42,2,11,1,914,956
13297,14,1,11,0,915,929
25207,14,1,11,0,915,929
6649,13,1,11,0,916,929
13767,15,5,11,0,916,931
20080,35,3,11,1,916,951
34810,20,5,11,0,916,936
41241,13,2,11,0,916,929
43033,13,1,11,0,916,929
43169,33,1,11,0,916,949
45256,20,1,11,0,916,936
68180,13,2,11,0,916,929
71160,12,1,11,0,916,928
84223,10,1,11,0,916,926
90336,13,3,11,0,916,929
96348,15,1,11,0,916,931
97055,21,3,11,0,916,937
97397,20,2,11,0,916,936
12355,9,1,11,0,917,926
14668,9,1,11,0,917,926
28932,10,1,11,0,917,927
30793,20,1,11,0,917,937
41776,9,1,11,0,917,926
42341,10,1,11,0,917,927
58392,25,2,11,1,917,942
88857,10,1,11,0,917,927
100882,9,1,11,0,917,926
114485,11,1,11,0,917,928
120201,10,1,11,0,917,927
15408,9,1,11,0,918,927
16356,10,2,11,0,918,928
18035,9,1,11,0,918,927
22110,10,1,11,0,918,928
23650,8,2,11,0,918,926
25224,9,1,11,0,918,927
28445,9,2,11,0,918,927
30502,9,1,11,0,918,927
31577,10,1,11,0,918,928
33011,9,3,11,0,918,927
37644,9,1,11,0,918,927
40578,10,2,11,0,918,928
43042,8,1,11,0,918,926
43353,9,1,11,0,918,927
44617,9,3,11,0,918,927
46232,9,1,11,0,918,927
47254,9,1,11,0,918,927
48611,9,1,11,0,918,927
48622,9,1,11,0,918,927
50899,9,1,11,0,918,927
51377,9,1,11,0,918,927
53224,10,1,11,0,918,928
54931,10,1,11,0,918,928
56870,10,1,11,0,918,928
60947,9,1,11,0,918,927
60975,8,1,11,0,918,926
63199,9,1,11,0,918,927
63809,10,2,11,0,918,928
66320,8,1,11,0,918,926
68495,9,3,11,0,918,927
70439,9,1,11,0,918,927
70972,10,1,11,0,918,928
71937,9,1,11,0,918,927
72385,9,1,11,0,918,927
74623,9,1,11,0,918,927
77746,10,1,11,0,918,928
78532,9,1,11,0,918,927
82650,9,3,11,0,918,927
96544,9,3,11,0,918,927
105511,9,2,11,0,918,927
109706,9,1,11,0,918,927
110349,10,1,11,0,918,928
111200,9,5,11,0,918,927
119111,10,5,11,0,918,928
121681,9,1,11,0,918,927
122464,10,1,11,0,918,928
122574,9,1,11,0,918,927
122699,9,1,11,0,918,927
6419,7,1,11,0,919,926
24563,7,3,11,0,919,926
70078,8,1,11,0,919,927
82456,7,4,11,0,919,926
94286,7,1,11,0,919,926
97889,7,2,11,0,919,926
117413,8,1,11,0,919,927
28065,14,1,11,0,920,934
31518,14,1,11,0,920,934
31603,14,1,11,0,920,934
32297,14,1,11,0,920,934
49124,5,2,11,0,920,925
64203,14,1,11,0,920,934
73670,14,1,11,0,920,934
76667,14,1,11,0,920,934
93998,129,4,13,0,920,1049
102867,14,1,11,0,920,934
108222,14,1,11,0,920,934
110125,14,1,11,0,920,934
111302,5,3,11,0,920,925
120601,14,1,11,0,920,934
125724,14,1,11,0,920,934
46509,35,1,11,0,921,956
68268,36,1,11,0,921,957
74416,3,1,11,0,921,924
103626,31,6,11,0,921,952
121732,39,1,11,1,921,960
53050,37,2,11,1,922,959
55225,15,1,11,0,922,937
68715,25,2,11,0,922,947
69014,15,3,11,0,922,937
69619,24,1,11,1,922,946
96477,31,4,11,1,922,953
125213,2,1,11,0,922,924
58339,14,1,11,0,923,937
16286,22,1,11,1,924,946
38908,14,1,11,0,924,938
54101,22,1,11,1,924,946
64737,22,1,11,1,924,946
85842,22,1,11,1,924,946
89124,39,2,11,1,924,963
105834,22,1,11,1,924,946
125650,22,1,11,1,924,946
129465,39,1,11,1,924,963
5948,69,3,12,0,925,994
11858,66,1,12,0,925,991
12379,10,1,11,0,925,935
43330,9,1,11,0,925,934
43509,66,1,12,0,925,991
48795,9,1,11,0,925,934
54974,9,3,11,0,925,934
83279,66,1,12,0,925,991
95397,179,3,15,1,925,1104
104624,27,1,11,0,925,952
107640,10,1,11,0,925,935
115803,27,2,11,0,925,952
120956,50,2,11,1,925,975
127614,66,5,12,0,925,991
128289,10,1,11,0,925,935
76395,45,3,11,1,926,971
91774,47,2,11,1,926,973
108119,47,2,11,1,926,973
118448,65,1,12,0,926,991
5655,16,1,11,1,927,943
11748,16,1,11,1,927,943
11788,16,1,11,1,927,943
15219,16,1,11,1,927,943
17290,16,2,11,1,927,943
17363,16,1,11,1,927,943
18805,40,2,11,1,927,967
20009,16,2,11,1,927,943
23408,16,1,11,1,927,943
27625,16,1,11,0,927,943
33203,42,2,11,1,927,969
37487,16,3,11,1,927,943
61078,16,1,11,1,927,943
61335,16,1,11,1,927,943
63910,16,2,11,1,927,943
67636,44,2,11,1,927,971
68277,16,1,11,1,927,943
80486,16,1,11,1,927,943
80597,16,3,11,1,927,943
82167,16,5,11,1,927,943
85347,16,5,11,1,927,943
104128,16,1,11,1,927,943
116995,40,1,11,1,927,967
127062,83,4,12,1,927,1010
7433,15,1,11,0,928,943
17311,5,2,11,0,928,933
30102,29,1,11,0,928,957
45162,21,2,11,1,928,949
49064,46,2,11,1,928,974
89948,65,2,12,1,928,993
98319,14,4,11,1,928,942
84370,27,1,11,0,929,956
87346,62,2,12,0,929,991
22203,37,1,11,1,930,967
63790,90,2,13,1,930,1020
65829,17,2,11,1,930,947
85504,39,1,11,1,930,969
98105,39,1,11,1,930,969
108634,25,1,11,0,930,955
115166,38,2,11,1,930,968
120882,17,1,11,1,930,947
6508,21,1,11,0,931,952
15608,8,1,11,0,931,939
18735,23,1,11,0,931,954
24432,8,1,11,0,931,939
24433,25,6,11,0,931,956
25753,23,1,11,0,931,954
42156,23,1,11,0,931,954
45607,43,3,11,1,931,974
49666,23,1,11,0,931,954
49854,37,2,11,1,931,968
58320,37,2,11,1,931,968
60643,23,1,11,0,931,954
70755,8,1,11,0,931,939
74697,23,3,11,0,931,954
77155,23,1,11,0,931,954
77785,38,2,11,1,931,969
79373,8,2,11,0,931,939
79688,35,1,11,1,931,966
88175,8,1,11,0,931,939
101428,23,1,11,0,931,954
101467,23,3,11,0,931,954
115617,37,2,11,1,931,968
116239,16,4,11,1,931,947
122201,8,1,11,0,931,939
122464,8,2,11,0,931,939
123636,25,1,11,0,931,956
128191,60,1,12,0,931,991
129222,43,2,11,1,931,974
15077,20,5,11,0,932,952
17888,10,1,11,0,932,942
19474,23,1,11,0,932,955
24291,23,2,11,0,932,955
24662,23,1,11,0,932,955
26394,23,1,11,0,932,955
26619,23,1,11,0,932,955
27012,23,1,11,0,932,955
40936,19,3,11,1,932,951
42485,63,2,12,0,932,995
49060,23,1,11,0,932,955
53397,23,2,11,0,932,955
65575,23,1,11,0,932,955
72270,23,2,11,0,932,955
74922,69,4,12,1,932,1001
75072,155,5,14,0,932,1087
75979,23,1,11,0,932,955
77286,23,4,11,0,932,955
80058,23,1,11,0,932,955
85982,22,1,11,0,932,954
93858,23,2,11,0,932,955
98688,23,1,11,0,932,955
99700,23,1,11,0,932,955
100162,23,1,11,0,932,955
102532,23,3,11,0,932,955
111291,23,1,11,0,932,955
112813,23,1,11,0,932,955
120435,23,1,11,0,932,955
6461,13,2,11,1,933,946
34968,22,1,11,0,933,955
45125,32,3,11,1,933,965
57867,19,3,11,1,933,952
60506,4,1,11,0,933,937
61033,58,4,12,1,933,991
66130,157,1,14,0,933,1090
67263,39,2,11,1,933,972
79546,58,1,12,0,933,991
104232,30,1,11,1,933,963
121119,39,1,11,1,933,972
127553,24,1,11,0,933,957
129347,29,1,11,1,933,962
8305,123,1,13,0,934,1057
8335,9,1,11,1,934,943
10424,17,1,11,0,934,951
11396,17,1,11,0,934,951
19670,15,1,11,0,934,949
22195,15,1,11,0,934,949
24179,17,1,11,0,934,951
24872,19,3,11,0,934,953
25470,17,1,11,0,934,951
26407,134,5,14,0,934,1068
28167,17,1,11,0,934,951
29025,17,1,11,0,934,951
29053,17,1,11,0,934,951
30950,17,1,11,0,934,951
34818,15,1,11,0,934,949
35927,144,1,14,0,934,1078
37416,17,1,11,0,934,951
37644,146,2,14,0,934,1080
41638,147,1,14,0,934,1081
41830,17,1,11,0,934,951
44864,17,1,11,0,934,951
47730,126,1,14,0,934,1060
51329,152,3,14,0,934,1086
53978,17,1,11,0,934,951
54445,29,1,11,1,934,963
58674,15,1,11,0,934,949
64928,29,1,11,1,934,963
66453,17,1,11,0,934,951
70473,17,1,11,0,934,951
77574,17,1,11,0,934,951
77612,147,1,14,0,934,1081
78710,17,1,11,0,934,951
85624,29,1,11,1,934,963
90626,17,1,11,0,934,951
91580,17,1,11,0,934,951
100701,17,1,11,0,934,951
101514,152,1,14,0,934,1086
102301,10,4,11,1,934,944
117816,29,1,11,1,934,963
122190,137,1,14,0,934,1071
123030,132,1,14,0,934,1066
123401,149,1,14,0,934,1083
5787,17,1,11,0,935,952
6573,17,1,11,0,935,952
9263,56,6,12,0,935,991
11370,56,1,12,0,935,991
13297,18,2,11,0,935,953
13391,17,4,11,0,935,952
15089,29,2,11,1,935,964
17016,17,1,11,0,935,952
19088,17,1,11,0,935,952
20302,17,2,11,0,935,952
20391,56,1,12,0,935,991
20885,17,3,11,0,935,952
21099,16,1,11,0,935,951
23686,17,1,11,0,935,952
25736,152,1,14,0,935,1087
26148,17,1,11,0,935,952
29524,56,1,12,0,935,991
30260,17,1,11,0,935,952
32963,56,1,12,0,935,991
33509,17,1,11,0,935,952
34009,17,2,11,0,935,952
35704,17,2,11,0,935,952
36364,13,1,11,0,935,948
37005,17,1,11,0,935,952
37746,27,1,11,1,935,962
39053,25,5,11,1,935,960
39221,17,1,11,0,935,952
39708,56,1,12,0,935,991
39810,17,1,11,0,935,952
42802,17,1,11,0,935,952
49474,17,1,11,0,935,952
50121,17,2,11,0,935,952
50482,17,1,11,0,935,952
51998,152,1,14,0,935,1087
52156,17,1,11,0,935,952
55828,17,1,11,0,935,952
60838,18,1,11,0,935,953
60885,13,1,11,0,935,948
61953,17,1,11,0,935,952
67592,17,1,11,0,935,952
68180,17,3,11,0,935,952
69153,17,1,11,0,935,952
73743,17,1,11,0,935,952
74009,56,1,12,0,935,991
76880,13,2,11,0,935,948
77190,17,1,11,0,935,952
77544,17,1,11,0,935,952
79269,17,1,11,0,935,952
82650,140,4,14,0,935,1075
83796,13,1,11,0,935,948
84764,17,1,11,0,935,952
86816,17,4,11,0,935,952
87784,17,1,11,0,935,952
88383,29,2,11,1,935,964
88678,56,1,12,0,935,991
89707,17,1,11,0,935,952
89856,13,1,11,0,935,948
89860,17,1,11,0,935,952
90424,27,1,11,1,935,962
98763,56,1,12,0,935,991
102063,56,1,12,0,935,991
102877,17,1,11,0,935,952
105547,17,1,11,0,935,952
105594,17,1,11,0,935,952
106589,17,2,11,0,935,952
107151,17,2,11,0,935,952
107460,17,1,11,0,935,952
110727,17,1,11,0,935,952
111306,56,1,12,0,935,991
112330,17,4,11,0,935,952
119378,56,1,12,0,935,991
121622,17,4,11,0,935,952
121786,17,1,11,0,935,952
125224,56,2,12,0,935,991
127902,17,1,11,0,935,952
128139,13,1,11,0,935,948
129048,17,2,11,0,935,952
129861,17,1,11,0,935,952
9169,13,3,11,0,936,949
9365,65,2,12,1,936,1001
10739,18,1,11,0,936,954
13285,57,3,12,1,936,993
14888,15,1,11,0,936,951
28445,17,3,11,0,936,953
32243,28,2,11,1,936,964
47353,17,1,11,0,936,953
51857,18,1,11,0,936,954
85430,27,1,11,1,936,963
90643,58,1,12,0,936,994
90905,55,1,12,0,936,991
30576,54,1,12,0,937,991
31786,54,1,12,0,937,991
115113,27,3,11,1,937,964
35772,31,1,11,1,938,969
63483,17,1,11,0,938,955
125774,17,1,11,0,938,955
12785,14,3,11,0,939,953
28516,16,1,11,1,939,955
52767,14,1,11,0,939,953
85334,2,1,11,0,939,941
126930,137,1,14,0,939,1076
21468,16,1,11,0,940,956
70813,10,1,11,0,940,950
74186,51,1,12,0,940,991
29865,12,3,11,1,941,953
42768,11,1,11,0,941,952
57484,11,1,11,0,941,952
59018,11,1,11,0,941,952
64880,8,1,11,0,941,949
59328,144,1,14,0,942,1086
107995,14,1,11,1,942,956
68401,53,1,12,1,943,996
121919,53,1,12,1,943,996
119257,9,1,11,0,945,954
125611,10,2,11,0,945,955
26464,47,1,12,0,947,994
72789,24,2,11,0,947,971
76155,44,2,12,0,947,991
94664,47,1,12,0,947,994
111198,6,4,11,0,947,953
128883,6,1,11,0,947,953
12631,5,1,11,0,948,953
17046,5,5,11,0,948,953
17053,5,1,11,0,948,953
21294,5,1,11,1,948,953
25216,5,2,11,0,948,953
26577,5,1,11,0,948,953
28794,5,1,11,0,948,953
33275,5,1,11,0,948,953
39324,5,1,11,0,948,953
41241,5,3,11,0,948,953
56687,5,1,11,0,948,953
58339,5,2,11,0,948,953
61989,5,1,11,0,948,953
81344,5,5,11,0,948,953
88685,5,1,11,0,948,953
95781,5,1,11,0,948,953
96684,5,2,11,0,948,953
99049,5,4,11,0,948,953
100988,5,1,11,0,948,953
101672,5,1,11,0,948,953
102820,5,1,11,0,948,953
102997,5,5,11,0,948,953
110291,5,1,11,0,948,953
113688,5,1,11,0,948,953
118866,5,2,11,0,948,953
119705,5,1,11,0,948,953
125269,5,2,11,0,948,953
6885,42,1,12,0,949,991
10655,3,1,11,0,949,952
10679,42,1,12,0,949,991
17400,42,1,12,0,949,991
48836,42,1,12,0,949,991
81329,42,4,12,0,949,991
101400,42,1,12,0,949,991
127683,4,3,11,0,949,953
86456,41,2,12,0,950,991
89890,39,1,12,0,952,991
68268,28,2,12,0,960,988
69689,8,2,11,0,960,968
110203,34,1,12,0,960,994
10739,33,2,12,0,961,994
11632,33,6,12,0,961,994
12631,33,2,12,0,961,994
41851,33,2,12,0,961,994
51857,33,2,12,0,961,994
55190,33,2,12,0,961,994
55689,27,3,12,0,961,988
69977,28,1,12,0,961,989
123880,27,2,12,0,961,988
46509,25,2,12,0,962,987
54659,31,4,12,0,962,993
66407,25,4,12,0,962,987
97703,25,1,12,0,962,987
104453,25,3,12,0,962,987
5656,23,1,12,0,963,986
6461,13,3,11,1,963,976
17588,23,2,12,0,963,986
17616,23,2,12,0,963,986
22038,23,4,12,0,963,986
24291,23,3,12,0,963,986
26702,22,1,12,0,963,985
57867,13,4,11,1,963,976
58339,23,3,12,0,963,986
65575,23,2,12,0,963,986
80058,23,2,12,0,963,986
80604,23,1,12,0,963,986
97533,25,3,12,0,963,988
103547,24,6,12,0,963,987
112813,23,2,12,0,963,986
125611,23,3,12,0,963,986
7430,27,1,12,0,964,991
7870,27,1,12,0,964,991
8884,27,1,12,0,964,991
9169,27,4,12,0,964,991
9558,27,5,12,0,964,991
19099,27,1,12,0,964,991
21612,27,1,12,0,964,991
32383,27,1,12,0,964,991
33651,27,3,12,0,964,991
35923,27,2,12,0,964,991
38977,27,3,12,0,964,991
42631,27,3,12,0,964,991
45259,27,1,12,0,964,991
52597,27,3,12,0,964,991
52964,27,3,12,0,964,991
55747,26,3,12,0,964,990
64880,27,2,12,0,964,991
68495,27,4,12,0,964,991
70813,26,2,12,0,964,990
71840,26,3,12,0,964,990
85298,27,3,12,0,964,991
85347,37,6,12,1,964,1001
94194,23,3,12,0,964,987
94941,24,5,12,0,964,988
97042,27,2,12,0,964,991
97840,26,1,12,0,964,990
104624,23,2,12,0,964,987
105710,27,7,12,0,964,991
110727,27,2,12,0,964,991
112208,27,3,12,0,964,991
112609,37,2,12,1,964,1001
115358,27,4,12,0,964,991
115803,25,3,12,0,964,989
126455,27,4,12,0,964,991
127455,27,4,12,0,964,991
128612,27,3,12,0,964,991
16012,23,1,12,0,965,988
18223,23,2,12,0,965,988
32990,25,4,12,0,965,990
70536,23,4,12,0,965,988
87816,23,2,12,0,965,988
95204,23,5,12,0,965,988
6573,17,2,12,0,966,983
7281,17,4,12,0,966,983
9741,17,2,12,0,966,983
9836,17,6,12,0,966,983
12379,17,2,12,0,966,983
16573,17,4,12,0,966,983
19114,17,1,12,0,966,983
23018,17,4,12,0,966,983
23686,17,2,12,0,966,983
30260,17,2,12,0,966,983
32186,17,2,12,0,966,983
39564,17,4,12,0,966,983
42206,17,3,12,0,966,983
42341,19,2,12,0,966,985
43949,17,2,12,0,966,983
54974,17,4,12,0,966,983
59468,17,2,12,0,966,983
69867,17,2,12,0,966,983
74105,14,1,12,0,966,980
92991,27,3,12,1,966,993
105594,17,2,12,0,966,983
107151,17,3,12,0,966,983
107640,17,2,12,0,966,983
111910,17,2,12,0,966,983
115048,17,5,12,0,966,983
119434,17,1,12,0,966,983
121025,17,2,12,0,966,983
123264,17,1,12,0,966,983
124268,17,2,12,0,966,983
128289,17,2,12,0,966,983
81009,16,2,12,0,967,983
129048,18,3,12,0,967,985
29797,9,1,11,0,968,977
79886,13,8,12,0,968,981
93678,9,1,11,0,968,977
109762,14,4,12,0,968,982
116683,15,2,12,0,968,983
78991,10,2,11,0,969,979
127705,4,1,11,0,969,973
72789,18,3,12,0,979,997
6240,12,1,12,0,981,993
24433,14,7,12,0,981,995
43788,7,3,12,0,981,988
65400,13,5,12,0,981,994
67321,13,5,12,0,981,994
119394,14,4,12,0,981,995
25364,10,2,12,0,983,993
45791,10,3,12,0,983,993
69689,9,3,12,0,983,992
91357,9,3,12,0,983,992
111198,11,5,12,0,983,994
113140,9,4,12,0,983,992
17402,3,1,12,0,987,990
81424,2,6,12,0,987,989
92101,27,1,12,0,987,1014
129222,2,3,12,0,987,989
64882,27,1,12,0,988,1015
11855,23,1,12,0,989,1012
45607,35,4,13,1,989,1024
86969,23,1,12,0,989,1012
87036,23,1,12,0,989,1012
95630,23,1,12,0,989,1012
17046,23,6,12,0,990,1013
25216,23,3,12,0,990,1013
27843,9,1,12,0,990,999
36738,23,1,12,0,990,1013
121732,40,2,13,1,990,1030
122555,23,1,12,0,990,1013
125269,23,3,12,0,990,1013
125611,23,4,12,0,990,1013
129732,23,1,12,0,990,1013
49124,21,3,12,0,991,1012
17888,18,2,12,0,992,1010
77155,17,2,12,0,992,1009
108119,40,3,13,1,992,1032
9208,17,1,12,0,993,1010
18221,17,1,12,0,993,1010
22763,17,1,12,0,993,1010
25549,17,1,12,0,993,1010
26750,17,1,12,0,993,1010
40335,16,1,12,0,993,1009
51415,17,3,12,0,993,1010
53410,17,1,12,0,993,1010
58656,17,1,12,0,993,1010
58757,17,1,12,0,993,1010
69250,17,3,12,0,993,1010
70918,17,2,12,0,993,1010
72545,17,1,12,0,993,1010
75053,17,1,12,0,993,1010
77696,17,1,12,0,993,1010
78167,17,2,12,0,993,1010
78622,17,1,12,0,993,1010
93573,19,1,12,0,993,1012
93858,17,3,12,0,993,1010
94082,17,1,12,0,993,1010
96464,17,2,12,0,993,1010
97042,17,3,12,0,993,1010
118663,17,1,12,0,993,1010
124111,17,2,12,0,993,1010
22714,13,2,12,0,994,1007
27068,13,1,12,0,995,1008
58339,10,4,12,0,996,1006
123058,29,2,13,1,996,1025
15074,11,1,12,0,997,1008
49854,24,3,13,1,997,1021
58320,60,3,13,1,997,1057
69689,9,4,12,0,997,1006
77785,28,3,13,1,997,1025
109650,16,1,12,0,997,1013
115617,44,3,13,1,997,1041
119007,11,1,12,0,997,1008
61033,16,5,12,1,998,1014
12622,9,1,12,0,999,1008
107995,16,2,12,1,1000,1016
17821,9,1,12,0,1001,1010
32243,19,3,13,1,1001,1020
88383,22,3,13,1,1001,1023
115113,152,4,16,1,1001,1153
15089,17,3,12,1,1002,1019
89948,12,3,12,1,1003,1015
78262,36,1,13,1,1004,1040
81366,18,1,13,0,1004,1022
120956,154,3,16,1,1004,1158
35772,151,2,16,1,1006,1157
53050,71,3,14,1,1006,1077
68720,107,1,15,1,1006,1113
85430,7,2,12,1,1006,1013
67263,127,3,15,1,1007,1134
97703,68,2,14,0,1007,1075
17588,67,3,14,0,1008,1075
121119,125,2,15,1,1008,1133
50169,22,1,13,1,1009,1031
77150,105,1,15,1,1010,1115
11868,60,1,14,0,1011,1071
13454,69,1,14,0,1011,1080
19114,61,2,14,0,1011,1072
24430,60,1,14,0,1011,1071
25821,59,1,14,0,1011,1070
32186,60,3,14,0,1011,1071
32343,61,1,14,0,1011,1072
40808,60,1,14,0,1011,1071
41143,60,1,14,0,1011,1071
43949,60,3,14,0,1011,1071
49164,69,1,14,0,1011,1080
55011,6,2,12,0,1011,1017
64184,60,2,14,0,1011,1071
67308,61,1,14,0,1011,1072
71102,60,1,14,0,1011,1071
102877,60,2,14,0,1011,1071
123264,60,2,14,0,1011,1071
127705,60,2,14,0,1011,1071
45330,2,1,12,0,1013,1015
46509,87,3,15,0,1013,1100
50274,35,1,13,0,1014,1049
98105,54,2,14,1,1014,1068
115166,35,3,13,1,1014,1049
104960,123,1,15,1,1015,1138
6145,19,1,13,1,1016,1035
49064,136,3,16,1,1017,1153
97405,76,2,14,1,1017,1093
129222,64,4,14,1,1017,1081
37487,16,4,13,1,1018,1034
67661,133,2,16,1,1018,1151
27784,32,1,13,0,1019,1051
60947,44,2,14,0,1019,1063
12570,20,1,13,0,1020,1040
18805,50,3,14,1,1020,1070
76624,18,3,13,1,1020,1038
127062,54,5,14,1,1020,1074
62528,16,2,13,1,1021,1037
96534,29,1,13,0,1022,1051
15219,12,2,13,0,1023,1035
21294,49,2,14,1,1023,1072
96684,43,3,14,1,1023,1066
97818,12,1,13,0,1023,1035
100464,13,3,13,0,1023,1036
126617,12,1,13,0,1023,1035
10032,16,1,13,1,1024,1040
23545,39,1,14,0,1024,1063
27843,68,2,14,0,1024,1092
89966,44,2,14,0,1024,1068
96425,46,5,14,1,1024,1070
97610,82,1,15,1,1024,1106
104883,39,1,14,0,1024,1063
9034,26,1,13,0,1025,1051
11388,44,1,14,0,1025,1069
21745,29,1,13,0,1025,1054
23196,47,1,14,0,1025,1072
24433,50,8,14,0,1025,1075
40786,23,2,13,0,1025,1048
69722,43,3,14,0,1025,1068
69977,45,2,14,0,1025,1070
71812,8,2,13,0,1025,1033
77286,35,5,14,0,1025,1060
115486,38,1,14,0,1025,1063
12631,43,3,14,0,1026,1069
18618,27,1,13,0,1026,1053
24727,29,1,13,0,1026,1055
26464,43,2,14,0,1026,1069
42631,44,4,14,0,1026,1070
68268,70,3,14,0,1026,1096
70443,27,1,13,0,1026,1053
71586,13,1,13,0,1026,1039
90643,39,2,14,0,1026,1065
92392,145,3,16,0,1026,1171
94664,44,2,14,0,1026,1070
102820,27,2,13,0,1026,1053
108193,41,1,14,0,1026,1067
110203,27,2,13,0,1026,1053
121767,41,1,14,0,1026,1067
123636,66,2,14,0,1026,1092
5656,18,2,13,0,1027,1045
5948,39,4,14,0,1027,1066
8893,39,1,14,0,1027,1066
9498,39,1,14,0,1027,1066
10538,25,1,13,0,1027,1052
10739,54,3,14,0,1027,1081
11932,39,1,14,0,1027,1066
14100,39,1,14,0,1027,1066
15191,39,2,14,0,1027,1066
16876,39,1,14,0,1027,1066
17616,41,3,14,0,1027,1068
20302,39,3,14,0,1027,1066
21453,39,1,14,0,1027,1066
21705,39,1,14,0,1027,1066
22110,37,2,14,0,1027,1064
22758,39,1,14,0,1027,1066
23408,39,2,14,0,1027,1066
24291,63,4,14,0,1027,1090
24555,39,1,14,0,1027,1066
24567,39,1,14,0,1027,1066
25033,39,1,14,0,1027,1066
25221,39,1,14,0,1027,1066
25901,39,1,14,0,1027,1066
26065,39,1,14,0,1027,1066
26148,39,2,14,0,1027,1066
26702,93,2,15,0,1027,1120
27670,39,1,14,0,1027,1066
27684,39,1,14,0,1027,1066
28349,39,1,14,0,1027,1066
28790,39,1,14,0,1027,1066
29255,39,1,14,0,1027,1066
29430,39,1,14,0,1027,1066
30316,39,1,14,0,1027,1066
31970,47,2,14,1,1027,1074
33011,173,4,17,0,1027,1200
33164,39,1,14,0,1027,1066
35313,39,1,14,0,1027,1066
35926,39,1,14,0,1027,1066
36917,39,1,14,0,1027,1066
38224,36,2,14,0,1027,1063
42206,39,4,14,0,1027,1066
44617,39,4,14,0,1027,1066
46875,25,1,13,0,1027,1052
48357,39,1,14,0,1027,1066
50390,39,1,14,0,1027,1066
51130,39,1,14,0,1027,1066
51857,53,3,14,0,1027,1080
52267,39,1,14,0,1027,1066
52293,39,1,14,0,1027,1066
52767,26,2,13,0,1027,1053
54659,36,5,14,0,1027,1063
54747,39,1,14,0,1027,1066
56161,39,1,14,0,1027,1066
57532,39,1,14,0,1027,1066
57774,39,1,14,0,1027,1066
60291,41,2,14,0,1027,1068
63866,39,1,14,0,1027,1066
64177,39,1,14,0,1027,1066
64923,39,1,14,0,1027,1066
65552,39,1,14,0,1027,1066
65575,63,3,14,0,1027,1090
66131,39,1,14,0,1027,1066
66381,39,1,14,0,1027,1066
66483,49,1,14,0,1027,1076
67236,39,6,14,0,1027,1066
68152,39,1,14,0,1027,1066
71055,39,1,14,0,1027,1066
71928,39,1,14,0,1027,1066
72586,38,1,14,0,1027,1065
72874,39,6,14,0,1027,1066
74125,39,1,14,0,1027,1066
74474,39,1,14,0,1027,1066
74606,15,4,13,0,1027,1042
75096,39,1,14,0,1027,1066
75416,39,1,14,0,1027,1066
76285,39,1,14,0,1027,1066
78774,39,1,14,0,1027,1066
79546,60,2,14,0,1027,1087
79917,54,1,14,0,1027,1081
79970,39,1,14,0,1027,1066
80058,63,3,14,0,1027,1090
80070,39,1,14,0,1027,1066
80579,39,1,14,0,1027,1066
80604,54,2,14,0,1027,1081
81412,46,4,14,0,1027,1073
82443,39,3,14,0,1027,1066
86322,39,1,14,0,1027,1066
89781,39,1,14,0,1027,1066
92133,39,1,14,0,1027,1066
92776,39,1,14,0,1027,1066
92828,39,1,14,0,1027,1066
92985,39,1,14,0,1027,1066
93638,39,1,14,0,1027,1066
94982,39,1,14,0,1027,1066
95911,39,1,14,0,1027,1066
96477,61,5,14,0,1027,1088
96544,43,4,14,0,1027,1070
98684,39,1,14,0,1027,1066
99868,39,1,14,0,1027,1066
101467,39,4,14,0,1027,1066
103492,39,1,14,0,1027,1066
104453,20,4,13,0,1027,1047
104825,39,1,14,0,1027,1066
108321,39,1,14,0,1027,1066
108989,39,3,14,0,1027,1066
109456,25,1,13,0,1027,1052
109675,39,1,14,0,1027,1066
110411,39,1,14,0,1027,1066
110483,39,1,14,0,1027,1066
111451,39,1,14,0,1027,1066
111544,39,1,14,0,1027,1066
112214,39,1,14,0,1027,1066
112663,39,1,14,0,1027,1066
112813,63,3,14,0,1027,1090
112848,21,1,13,0,1027,1048
114994,48,1,14,0,1027,1075
116343,39,1,14,0,1027,1066
117420,39,1,14,0,1027,1066
118678,25,1,13,0,1027,1052
118712,39,1,14,0,1027,1066
119257,53,2,14,0,1027,1080
121222,39,1,14,0,1027,1066
122336,39,2,14,0,1027,1066
123831,39,1,14,0,1027,1066
125611,55,5,14,0,1027,1082
125776,39,1,14,0,1027,1066
126659,45,3,14,0,1027,1072
128495,39,1,14,0,1027,1066
129544,39,1,14,0,1027,1066
7336,35,1,14,0,1028,1063
8189,29,1,13,1,1028,1057
9176,23,1,13,0,1028,1051
10868,23,1,13,0,1028,1051
13270,23,1,13,0,1028,1051
15079,23,1,13,0,1028,1051
17290,38,3,14,1,1028,1066
17363,23,2,13,0,1028,1051
20080,23,4,13,0,1028,1051
20905,32,1,14,0,1028,1060
22967,23,1,13,0,1028,1051
24872,163,4,17,0,1028,1191
26688,23,1,13,0,1028,1051
27390,23,1,13,0,1028,1051
28445,50,4,14,0,1028,1078
30172,23,1,13,0,1028,1051
30950,23,2,13,0,1028,1051
32885,28,5,13,0,1028,1056
33509,23,2,13,0,1028,1051
33619,23,1,13,0,1028,1051
34968,62,2,14,0,1028,1090
35285,35,1,14,0,1028,1063
36094,29,1,13,0,1028,1057
37026,23,1,13,0,1028,1051
37348,42,3,14,0,1028,1070
37815,23,1,13,0,1028,1051
38552,23,1,13,0,1028,1051
41098,23,1,13,0,1028,1051
42675,23,1,13,0,1028,1051
43173,23,1,13,0,1028,1051
46045,31,1,13,0,1028,1059
47353,60,2,14,0,1028,1088
48078,23,1,13,0,1028,1051
48146,8,1,13,0,1028,1036
50059,23,1,13,0,1028,1051
50563,23,1,13,0,1028,1051
52146,40,1,14,0,1028,1068
52412,23,1,13,0,1028,1051
56211,23,1,13,0,1028,1051
57444,23,1,13,0,1028,1051
58004,23,1,13,0,1028,1051
62748,29,1,13,0,1028,1057
64208,23,1,13,0,1028,1051
64814,20,1,13,0,1028,1048
66807,35,1,14,0,1028,1063
67459,23,1,13,0,1028,1051
68296,23,1,13,0,1028,1051
68939,23,1,13,0,1028,1051
71436,23,1,13,0,1028,1051
73039,23,1,13,0,1028,1051
74334,31,1,13,0,1028,1059
79308,23,1,13,0,1028,1051
80610,35,2,14,0,1028,1063
80807,23,1,13,0,1028,1051
81593,23,1,13,0,1028,1051
81634,23,1,13,0,1028,1051
84574,23,1,13,0,1028,1051
85116,79,1,15,0,1028,1107
85921,23,1,13,0,1028,1051
87200,23,1,13,0,1028,1051
88719,23,1,13,0,1028,1051
90289,23,1,13,0,1028,1051
91271,23,1,13,0,1028,1051
91728,23,1,13,0,1028,1051
95063,23,1,13,0,1028,1051
95767,23,1,13,0,1028,1051
102757,23,1,13,0,1028,1051
102997,46,6,14,0,1028,1074
103185,31,1,13,0,1028,1059
107624,23,1,13,0,1028,1051
107995,43,3,14,1,1028,1071
112582,23,1,13,0,1028,1051
113002,31,1,13,0,1028,1059
115590,23,1,13,0,1028,1051
118355,23,1,13,0,1028,1051
123038,23,1,13,0,1028,1051
123816,94,1,15,0,1028,1122
124196,23,1,13,0,1028,1051
127594,23,1,13,0,1028,1051
128188,23,1,13,0,1028,1051
129861,29,2,13,1,1028,1057
6885,34,2,14,0,1029,1063
7430,20,2,13,0,1029,1049
9263,34,7,14,0,1029,1063
10679,34,2,14,0,1029,1063
11370,35,2,14,0,1029,1064
12379,47,3,14,0,1029,1076
12617,54,1,14,1,1029,1083
13297,56,3,14,0,1029,1085
17053,52,2,14,0,1029,1081
17400,34,2,14,0,1029,1063
18026,38,1,14,0,1029,1067
18223,45,3,14,0,1029,1074
19099,39,2,14,0,1029,1068
20391,34,2,14,0,1029,1063
22285,17,2,13,0,1029,1046
26930,133,1,16,0,1029,1162
27246,62,1,14,0,1029,1091
29524,42,2,14,0,1029,1071
30576,38,2,14,0,1029,1067
31786,38,2,14,0,1029,1067
31805,72,1,15,0,1029,1101
32257,14,1,13,0,1029,1043
32383,20,2,13,0,1029,1049
32963,35,2,14,0,1029,1064
33275,43,2,14,0,1029,1072
35457,36,1,14,0,1029,1065
38091,37,2,14,0,1029,1066
39324,15,2,13,0,1029,1044
39708,146,2,16,0,1029,1175
40325,38,1,14,0,1029,1067
44121,20,2,13,0,1029,1049
45259,41,2,14,0,1029,1070
50216,40,1,14,0,1029,1069
58233,42,1,14,0,1029,1071
60838,61,2,14,0,1029,1090
61649,39,1,14,0,1029,1068
63790,37,3,14,1,1029,1066
66995,38,1,14,0,1029,1067
67163,37,1,14,0,1029,1066
67838,34,1,14,0,1029,1063
69014,180,4,17,0,1029,1209
74009,34,2,14,0,1029,1063
74882,19,1,13,0,1029,1048
74922,37,5,14,1,1029,1066
76155,25,3,13,0,1029,1054
78598,51,1,14,1,1029,1080
81329,34,5,14,0,1029,1063
81344,48,6,14,0,1029,1077
81424,55,7,14,0,1029,1084
85298,21,4,13,0,1029,1050
86308,22,1,13,0,1029,1051
86456,46,3,14,0,1029,1075
88678,34,2,14,0,1029,1063
89890,37,2,14,0,1029,1066
89930,38,1,14,0,1029,1067
94286,22,2,13,0,1029,1051
95781,40,2,14,0,1029,1069
97644,80,2,15,1,1029,1109
97648,32,1,14,0,1029,1061
98763,34,2,14,0,1029,1063
99049,41,5,14,0,1029,1070
100988,78,2,15,0,1029,1107
101400,42,2,14,0,1029,1071
102063,35,2,14,0,1029,1064
102088,14,1,13,0,1029,1043
102532,49,4,14,0,1029,1078
104194,38,1,14,0,1029,1067
105095,39,2,14,0,1029,1068
105504,4,1,13,0,1029,1033
106065,196,1,18,0,1029,1225
106396,34,3,14,0,1029,1063
107017,38,1,14,0,1029,1067
107789,15,1,13,0,1029,1044
110291,40,2,14,0,1029,1069
111306,34,2,14,0,1029,1063
119378,34,2,14,0,1029,1063
122274,20,1,13,0,1029,1049
123058,54,3,14,1,1029,1083
123880,19,3,13,0,1029,1048
125224,34,3,14,0,1029,1063
127455,37,5,14,0,1029,1066
6143,12,1,13,0,1030,1042
6573,70,3,15,0,1030,1100
7372,32,2,14,0,1030,1062
8884,21,2,13,0,1030,1051
9741,49,3,14,0,1030,1079
11858,57,2,14,0,1030,1087
13306,17,3,13,0,1030,1047
14533,27,3,13,1,1030,1057
14991,21,2,13,0,1030,1051
16573,45,5,14,0,1030,1075
16748,13,1,13,0,1030,1043
18935,38,4,14,0,1030,1068
20885,41,4,14,0,1030,1071
21612,51,2,14,0,1030,1081
22021,13,1,13,0,1030,1043
23686,57,3,14,0,1030,1087
23838,56,1,14,0,1030,1086
24421,21,2,13,0,1030,1051
24957,21,8,13,0,1030,1051
26563,19,1,13,0,1030,1049
26981,13,1,13,0,1030,1043
28723,20,1,13,0,1030,1050
30260,57,3,14,0,1030,1087
33457,82,5,15,1,1030,1112
34009,13,3,13,0,1030,1043
34460,3,1,13,0,1030,1033
35704,57,3,14,0,1030,1087
37005,55,2,14,0,1030,1085
38191,57,1,14,0,1030,1087
38977,21,4,13,0,1030,1051
39221,45,2,14,0,1030,1075
40578,49,3,14,1,1030,1079
41294,30,2,14,0,1030,1060
42341,21,3,13,0,1030,1051
43509,57,2,14,0,1030,1087
43664,34,2,14,0,1030,1064
44549,16,3,13,0,1030,1046
45151,21,2,13,0,1030,1051
45616,20,1,13,0,1030,1050
47871,18,1,13,0,1030,1048
48062,46,1,14,0,1030,1076
48287,13,1,13,0,1030,1043
48836,49,2,14,0,1030,1079
49666,33,2,14,0,1030,1063
52156,34,2,14,0,1030,1064
54785,13,1,13,0,1030,1043
55747,20,4,13,0,1030,1050
56207,13,3,13,0,1030,1043
59468,21,3,13,0,1030,1051
61033,33,6,14,1,1030,1063
64520,13,4,13,0,1030,1043
64880,53,3,14,1,1030,1083
65690,21,4,13,0,1030,1051
67592,46,2,14,0,1030,1076
70813,20,3,13,0,1030,1050
71840,20,4,13,0,1030,1050
73743,55,2,14,0,1030,1085
74186,45,2,14,0,1030,1075
77397,74,3,15,0,1030,1104
77634,23,2,13,0,1030,1053
78492,13,1,13,0,1030,1043
79688,15,2,13,1,1030,1045
81923,50,1,14,0,1030,1080
83279,57,2,14,0,1030,1087
84163,42,1,14,0,1030,1072
84764,44,2,14,0,1030,1074
85347,96,7,15,1,1030,1126
86816,43,5,14,0,1030,1073
87346,57,3,14,0,1030,1087
87816,30,3,14,0,1030,1060
89092,28,1,13,0,1030,1058
89860,33,2,14,0,1030,1063
90266,21,2,13,0,1030,1051
90424,15,2,13,1,1030,1045
90905,20,2,13,0,1030,1050
91996,20,5,13,0,1030,1050
92537,13,1,13,0,1030,1043
93481,33,1,14,0,1030,1063
93516,13,1,13,0,1030,1043
97042,20,4,13,0,1030,1050
97130,13,1,13,0,1030,1043
97840,20,2,13,0,1030,1050
103547,17,7,13,0,1030,1047
104624,21,3,13,0,1030,1051
105594,30,3,14,0,1030,1060
106668,34,2,14,0,1030,1064
107151,56,4,14,0,1030,1086
107460,37,2,14,0,1030,1067
107640,45,3,14,0,1030,1075
110727,21,3,13,0,1030,1051
111910,21,3,13,0,1030,1051
112521,47,1,14,0,1030,1077
112620,26,2,13,0,1030,1056
113123,38,1,14,0,1030,1068
115048,21,6,13,0,1030,1051
115803,64,4,14,0,1030,1094
118448,57,2,14,0,1030,1087
119434,31,2,14,0,1030,1061
121025,21,3,13,0,1030,1051
121328,35,2,14,0,1030,1065
121622,57,5,14,0,1030,1087
124268,4,3,13,0,1030,1034
126835,33,1,14,0,1030,1063
127614,57,6,14,0,1030,1087
127902,30,2,14,0,1030,1060
128191,57,2,14,0,1030,1087
129048,55,4,14,0,1030,1085
129105,33,1,14,0,1030,1063
5684,17,1,13,0,1031,1048
6019,17,1,13,0,1031,1048
6322,32,1,14,0,1031,1063
6643,32,1,14,0,1031,1063
6869,32,3,14,0,1031,1063
7073,32,1,14,0,1031,1063
7117,32,1,14,0,1031,1063
7338,32,1,14,0,1031,1063
7484,32,1,14,0,1031,1063
7498,17,1,13,0,1031,1048
7720,17,1,13,0,1031,1048
7852,17,1,13,0,1031,1048
7870,34,2,14,0,1031,1065
7969,32,1,14,0,1031,1063
8492,18,5,13,0,1031,1049
8556,32,1,14,0,1031,1063
8760,32,1,14,0,1031,1063
9020,32,1,14,0,1031,1063
9335,17,1,13,0,1031,1048
9365,17,3,13,0,1031,1048
9539,32,1,14,0,1031,1063
9630,17,1,13,0,1031,1048
9832,32,1,14,0,1031,1063
10138,73,2,15,0,1031,1104
10267,32,1,14,0,1031,1063
10557,32,1,14,0,1031,1063
10594,32,1,14,0,1031,1063
11133,32,1,14,0,1031,1063
11396,17,2,13,0,1031,1048
11439,17,1,13,0,1031,1048
11750,32,1,14,0,1031,1063
13285,9,4,13,1,1031,1040
13453,17,1,13,0,1031,1048
13459,32,1,14,0,1031,1063
13623,17,1,13,0,1031,1048
13767,57,6,14,0,1031,1088
14385,17,1,13,0,1031,1048
14610,32,1,14,0,1031,1063
14615,32,3,14,0,1031,1063
15061,32,1,14,0,1031,1063
15077,32,6,14,0,1031,1063
15187,32,1,14,0,1031,1063
15272,17,1,13,0,1031,1048
15394,39,1,14,0,1031,1070
15451,17,1,13,0,1031,1048
15560,17,1,13,0,1031,1048
16026,32,2,14,0,1031,1063
16088,32,2,14,0,1031,1063
16286,32,2,14,0,1031,1063
16399,17,1,13,0,1031,1048
16420,17,1,13,0,1031,1048
16529,32,1,14,0,1031,1063
16581,32,1,14,0,1031,1063
16813,32,1,14,0,1031,1063
17060,17,1,13,0,1031,1048
17238,17,1,13,0,1031,1048
17437,32,2,14,0,1031,1063
17496,32,1,14,0,1031,1063
18035,32,2,14,0,1031,1063
18058,32,1,14,0,1031,1063
18069,32,1,14,0,1031,1063
19174,17,1,13,0,1031,1048
19791,17,1,13,0,1031,1048
20022,41,1,14,0,1031,1072
20259,32,1,14,0,1031,1063
20392,32,1,14,0,1031,1063
20640,35,1,14,0,1031,1066
20943,17,1,13,0,1031,1048
21073,17,1,13,0,1031,1048
21130,32,1,14,0,1031,1063
21278,17,1,13,0,1031,1048
21307,17,1,13,0,1031,1048
21401,17,1,13,0,1031,1048
21621,17,1,13,0,1031,1048
21651,32,1,14,0,1031,1063
22203,31,2,14,0,1031,1062
22277,17,1,13,0,1031,1048
22432,32,3,14,0,1031,1063
22763,32,2,14,0,1031,1063
23018,17,5,13,0,1031,1048
23076,17,1,13,0,1031,1048
23485,17,1,13,0,1031,1048
23543,32,1,14,0,1031,1063
23597,17,1,13,0,1031,1048
23774,17,1,13,0,1031,1048
24284,17,1,13,0,1031,1048
24390,32,4,14,0,1031,1063
24454,32,1,14,0,1031,1063
24819,17,1,13,0,1031,1048
24845,32,1,14,0,1031,1063
24987,32,1,14,0,1031,1063
25470,17,2,13,0,1031,1048
25742,17,1,13,0,1031,1048
25917,45,1,14,0,1031,1076
25918,32,1,14,0,1031,1063
26099,32,1,14,0,1031,1063
26164,32,1,14,0,1031,1063
26183,32,1,14,0,1031,1063
26326,32,1,14,0,1031,1063
26370,32,1,14,0,1031,1063
26485,17,1,13,0,1031,1048
26673,17,1,13,0,1031,1048
26812,17,1,13,0,1031,1048
26855,32,1,14,0,1031,1063
26877,17,1,13,0,1031,1048
26933,32,1,14,0,1031,1063
27068,39,2,14,0,1031,1070
27613,17,1,13,0,1031,1048
27736,32,1,14,0,1031,1063
28127,17,1,13,0,1031,1048
28296,17,1,13,0,1031,1048
28345,17,1,13,0,1031,1048
28444,17,2,13,0,1031,1048
28764,73,2,15,0,1031,1104
29027,17,1,13,0,1031,1048
29127,17,2,13,0,1031,1048
30168,17,2,13,0,1031,1048
30502,32,2,14,0,1031,1063
30768,32,1,14,0,1031,1063
31041,17,1,13,0,1031,1048
31056,20,1,13,0,1031,1051
31082,17,3,13,0,1031,1048
31095,32,1,14,0,1031,1063
31183,32,1,14,0,1031,1063
31261,17,1,13,0,1031,1048
31560,17,1,13,0,1031,1048
31695,32,1,14,0,1031,1063
31725,32,1,14,0,1031,1063
32124,17,1,13,0,1031,1048
32245,32,1,14,0,1031,1063
32816,17,1,13,0,1031,1048
32819,32,1,14,0,1031,1063
32956,32,1,14,0,1031,1063
33110,17,1,13,0,1031,1048
33143,32,1,14,0,1031,1063
33246,17,1,13,0,1031,1048
33248,16,2,13,0,1031,1047
33724,17,1,13,0,1031,1048
34251,17,1,13,0,1031,1048
34314,17,1,13,0,1031,1048
34477,32,1,14,0,1031,1063
34704,17,2,13,0,1031,1048
34906,32,1,14,0,1031,1063
35452,32,1,14,0,1031,1063
35594,17,1,13,0,1031,1048
35697,32,1,14,0,1031,1063
35957,17,1,13,0,1031,1048
36049,32,1,14,0,1031,1063
36218,32,1,14,0,1031,1063
36360,17,1,13,0,1031,1048
36663,32,1,14,0,1031,1063
36777,32,1,14,0,1031,1063
36909,17,1,13,0,1031,1048
36940,17,1,13,0,1031,1048
37302,32,1,14,0,1031,1063
37498,32,1,14,0,1031,1063
37520,17,3,13,0,1031,1048
37808,32,1,14,0,1031,1063
38550,17,1,13,0,1031,1048
38560,17,1,13,0,1031,1048
38925,17,1,13,0,1031,1048
39032,17,1,13,0,1031,1048
39207,32,1,14,0,1031,1063
39414,32,1,14,0,1031,1063
39452,17,1,13,0,1031,1048
39598,32,1,14,0,1031,1063
39687,32,1,14,0,1031,1063
39810,32,2,14,0,1031,1063
39983,48,1,14,0,1031,1079
40119,32,1,14,0,1031,1063
40392,17,1,13,0,1031,1048
40493,17,1,13,0,1031,1048
41241,39,4,14,0,1031,1070
41465,32,1,14,0,1031,1063
41580,32,1,14,0,1031,1063
41669,36,1,14,0,1031,1067
41848,32,1,14,0,1031,1063
41888,17,1,13,0,1031,1048
41987,32,1,14,0,1031,1063
42370,31,1,14,0,1031,1062
42495,32,1,14,0,1031,1063
42693,17,1,13,0,1031,1048
42854,32,1,14,0,1031,1063
43071,32,1,14,0,1031,1063
43160,32,1,14,0,1031,1063
43161,17,1,13,0,1031,1048
43776,17,1,13,0,1031,1048
43901,17,1,13,0,1031,1048
44009,32,1,14,0,1031,1063
44140,32,1,14,0,1031,1063
44219,32,1,14,0,1031,1063
44475,32,2,14,0,1031,1063
44489,17,1,13,0,1031,1048
44691,17,1,13,0,1031,1048
44985,32,3,14,0,1031,1063
45109,17,1,13,0,1031,1048
45121,17,1,13,0,1031,1048
45265,17,1,13,0,1031,1048
45266,32,1,14,0,1031,1063
45619,32,1,14,0,1031,1063
46232,32,2,14,0,1031,1063
46545,17,1,13,0,1031,1048
46627,17,1,13,0,1031,1048
46720,32,1,14,0,1031,1063
46881,17,1,13,0,1031,1048
46923,17,1,13,0,1031,1048
47000,32,2,14,0,1031,1063
47158,17,1,13,0,1031,1048
47234,32,1,14,0,1031,1063
47350,32,1,14,0,1031,1063
47697,32,1,14,0,1031,1063
47968,32,1,14,0,1031,1063
48049,32,1,14,0,1031,1063
48460,32,1,14,0,1031,1063
48579,32,1,14,0,1031,1063
48776,32,1,14,0,1031,1063
48789,32,3,14,0,1031,1063
49128,17,1,13,0,1031,1048
49144,17,1,13,0,1031,1048
49496,32,1,14,0,1031,1063
49680,17,1,13,0,1031,1048
50282,17,1,13,0,1031,1048
50324,17,1,13,0,1031,1048
50371,32,1,14,0,1031,1063
51582,32,1,14,0,1031,1063
52029,32,1,14,0,1031,1063
52121,17,1,13,0,1031,1048
52373,17,1,13,0,1031,1048
52390,32,1,14,0,1031,1063
52964,32,4,14,0,1031,1063
53410,32,2,14,0,1031,1063
53634,32,1,14,0,1031,1063
53725,19,1,13,0,1031,1050
53781,17,1,13,0,1031,1048
55118,32,1,14,0,1031,1063
55506,32,1,14,0,1031,1063
55590,32,1,14,0,1031,1063
55684,32,1,14,0,1031,1063
56098,32,1,14,0,1031,1063
56870,39,2,14,0,1031,1070
57286,32,1,14,0,1031,1063
57926,32,1,14,0,1031,1063
58223,32,1,14,0,1031,1063
58398,17,1,13,0,1031,1048
58513,17,1,13,0,1031,1048
58701,17,1,13,0,1031,1048
58968,32,1,14,0,1031,1063
59233,32,1,14,0,1031,1063
60138,17,1,13,0,1031,1048
60638,17,1,13,0,1031,1048
60697,32,2,14,0,1031,1063
60857,17,1,13,0,1031,1048
61074,73,1,15,0,1031,1104
61251,32,1,14,0,1031,1063
61333,32,1,14,0,1031,1063
61596,17,2,13,0,1031,1048
61729,17,3,13,0,1031,1048
61928,32,1,14,0,1031,1063
62035,32,1,14,0,1031,1063
62282,17,4,13,0,1031,1048
62360,32,4,14,0,1031,1063
62746,32,1,14,0,1031,1063
63016,17,1,13,0,1031,1048
63045,32,1,14,0,1031,1063
63055,32,1,14,0,1031,1063
63141,32,1,14,0,1031,1063
63414,32,1,14,0,1031,1063
63854,32,1,14,0,1031,1063
63910,55,3,14,1,1031,1086
63965,17,1,13,0,1031,1048
64118,17,1,13,0,1031,1048
64507,17,1,13,0,1031,1048
65459,32,1,14,0,1031,1063
65489,19,1,13,0,1031,1050
65794,17,1,13,0,1031,1048
66304,17,1,13,0,1031,1048
66561,27,1,13,0,1031,1058
66825,32,3,14,0,1031,1063
67004,32,3,14,0,1031,1063
67205,32,1,14,0,1031,1063
67278,32,1,14,0,1031,1063
67362,17,1,13,0,1031,1048
67429,17,1,13,0,1031,1048
67436,17,1,13,0,1031,1048
67629,32,1,14,0,1031,1063
67972,17,1,13,0,1031,1048
67985,17,1,13,0,1031,1048
69032,32,1,14,0,1031,1063
69244,32,1,14,0,1031,1063
69392,32,1,14,0,1031,1063
69450,56,1,14,0,1031,1087
69465,32,2,14,0,1031,1063
69618,17,1,13,0,1031,1048
69797,32,1,14,0,1031,1063
69882,17,1,13,0,1031,1048
70222,21,1,13,0,1031,1052
70291,32,1,14,0,1031,1063
70402,32,1,14,0,1031,1063
70436,17,1,13,0,1031,1048
70786,32,1,14,0,1031,1063
70876,32,1,14,0,1031,1063
70888,32,1,14,0,1031,1063
71054,18,2,13,0,1031,1049
71079,32,1,14,0,1031,1063
71235,17,1,13,0,1031,1048
71568,32,1,14,0,1031,1063
71612,17,1,13,0,1031,1048
71811,27,1,13,0,1031,1058
71861,17,1,13,0,1031,1048
72199,32,1,14,0,1031,1063
72210,17,1,13,0,1031,1048
72254,32,1,14,0,1031,1063
72293,32,1,14,0,1031,1063
72446,32,3,14,0,1031,1063
72894,17,1,13,0,1031,1048
73013,32,1,14,0,1031,1063
73105,17,1,13,0,1031,1048
73458,17,1,13,0,1031,1048
74800,17,1,13,0,1031,1048
75530,32,1,14,0,1031,1063
75551,32,1,14,0,1031,1063
75577,32,1,14,0,1031,1063
75596,32,1,14,0,1031,1063
75670,17,1,13,0,1031,1048
76000,32,5,14,0,1031,1063
76269,17,1,13,0,1031,1048
76352,32,1,14,0,1031,1063
76741,17,1,13,0,1031,1048
76949,32,1,14,0,1031,1063
77395,17,1,13,0,1031,1048
77495,37,1,14,0,1031,1068
77692,32,1,14,0,1031,1063
77720,32,1,14,0,1031,1063
77749,56,2,14,0,1031,1087
77848,17,1,13,0,1031,1048
78065,32,1,14,0,1031,1063
78077,17,1,13,0,1031,1048
78525,32,1,14,0,1031,1063
78532,36,2,14,0,1031,1067
78667,32,1,14,0,1031,1063
78793,32,1,14,0,1031,1063
79886,35,9,14,0,1031,1066
79892,17,1,13,0,1031,1048
80691,35,3,14,0,1031,1066
80758,73,1,15,0,1031,1104
81155,47,1,14,0,1031,1078
81301,17,1,13,0,1031,1048
81366,32,2,14,0,1031,1063
81383,32,1,14,0,1031,1063
81886,32,2,14,0,1031,1063
82175,17,1,13,0,1031,1048
82367,32,1,14,0,1031,1063
82432,32,6,14,0,1031,1063
82826,32,1,14,0,1031,1063
82906,32,1,14,0,1031,1063
83258,15,1,13,0,1031,1046
83469,17,1,13,0,1031,1048
83641,32,1,14,0,1031,1063
83774,32,1,14,0,1031,1063
83872,32,1,14,0,1031,1063
84003,17,2,13,0,1031,1048
84012,32,1,14,0,1031,1063
84140,32,1,14,0,1031,1063
84618,17,1,13,0,1031,1048
84974,32,1,14,0,1031,1063
85034,17,1,13,0,1031,1048
85055,32,3,14,0,1031,1063
85163,32,1,14,0,1031,1063
85882,32,1,14,0,1031,1063
85909,56,1,14,0,1031,1087
86242,32,3,14,0,1031,1063
86488,32,1,14,0,1031,1063
86598,32,1,14,0,1031,1063
86796,17,1,13,0,1031,1048
86935,17,1,13,0,1031,1048
87029,32,1,14,0,1031,1063
87264,17,1,13,0,1031,1048
87588,17,1,13,0,1031,1048
88153,32,1,14,0,1031,1063
89252,32,1,14,0,1031,1063
89492,17,1,13,0,1031,1048
89548,32,1,14,0,1031,1063
90243,32,1,14,0,1031,1063
90790,32,3,14,0,1031,1063
90868,32,1,14,0,1031,1063
90934,17,2,13,0,1031,1048
91083,32,1,14,0,1031,1063
91237,35,1,14,0,1031,1066
91258,17,1,13,0,1031,1048
91322,32,1,14,0,1031,1063
91681,17,1,13,0,1031,1048
92076,32,1,14,0,1031,1063
92882,32,1,14,0,1031,1063
93194,32,2,14,0,1031,1063
93295,32,1,14,0,1031,1063
93952,32,1,14,0,1031,1063
94093,32,1,14,0,1031,1063
94114,17,1,13,0,1031,1048
94324,32,1,14,0,1031,1063
94392,32,1,14,0,1031,1063
95195,32,1,14,0,1031,1063
95238,17,1,13,0,1031,1048
95428,17,2,13,0,1031,1048
95655,17,1,13,0,1031,1048
95968,17,1,13,0,1031,1048
96059,36,1,14,0,1031,1067
96447,17,1,13,0,1031,1048
96589,32,1,14,0,1031,1063
96963,32,1,14,0,1031,1063
97296,17,1,13,0,1031,1048
97315,17,1,13,0,1031,1048
97445,32,1,14,0,1031,1063
97917,32,1,14,0,1031,1063
97920,32,1,14,0,1031,1063
98180,17,1,13,0,1031,1048
98190,32,1,14,0,1031,1063
98783,20,1,13,0,1031,1051
99048,17,1,13,0,1031,1048
99287,47,1,14,0,1031,1078
99535,32,1,14,0,1031,1063
99979,32,1,14,0,1031,1063
100162,32,2,14,0,1031,1063
100987,72,1,15,0,1031,1103
101114,32,1,14,0,1031,1063
101461,32,1,14,0,1031,1063
101525,46,1,14,0,1031,1077
101830,32,1,14,0,1031,1063
101908,32,1,14,0,1031,1063
102191,32,1,14,0,1031,1063
102284,17,5,13,0,1031,1048
102426,32,1,14,0,1031,1063
102620,17,1,13,0,1031,1048
102803,32,1,14,0,1031,1063
102807,32,1,14,0,1031,1063
103027,17,1,13,0,1031,1048
103032,32,1,14,0,1031,1063
103059,32,2,14,0,1031,1063
103487,32,1,14,0,1031,1063
103614,17,1,13,0,1031,1048
103626,32,7,14,0,1031,1063
103749,17,1,13,0,1031,1048
104062,19,1,13,0,1031,1050
104871,32,1,14,0,1031,1063
104949,32,1,14,0,1031,1063
105378,42,2,14,0,1031,1073
105699,17,4,13,0,1031,1048
105801,32,1,14,0,1031,1063
105834,17,2,13,0,1031,1048
106220,17,1,13,0,1031,1048
106589,44,3,14,0,1031,1075
106602,32,1,14,0,1031,1063
107790,17,3,13,0,1031,1048
107919,17,1,13,0,1031,1048
107999,36,1,14,0,1031,1067
108024,46,2,14,0,1031,1077
108115,32,1,14,0,1031,1063
108166,32,1,14,0,1031,1063
108375,10,1,13,0,1031,1041
108992,32,1,14,0,1031,1063
109687,17,2,13,0,1031,1048
109707,17,1,13,0,1031,1048
109855,17,1,13,0,1031,1048
110391,17,1,13,0,1031,1048
110688,17,1,13,0,1031,1048
110800,17,1,13,0,1031,1048
110824,32,5,14,0,1031,1063
110942,17,1,13,0,1031,1048
111021,32,1,14,0,1031,1063
111338,17,1,13,0,1031,1048
111556,32,1,14,0,1031,1063
111813,32,1,14,0,1031,1063
111928,32,1,14,0,1031,1063
112149,32,1,14,0,1031,1063
112177,17,1,13,0,1031,1048
112208,32,4,14,0,1031,1063
112483,32,6,14,0,1031,1063
112507,32,1,14,0,1031,1063
112966,32,1,14,0,1031,1063
113009,32,1,14,0,1031,1063
113172,17,1,13,0,1031,1048
113261,32,1,14,0,1031,1063
113636,17,1,13,0,1031,1048
113786,17,1,13,0,1031,1048
114159,32,1,14,0,1031,1063
114366,42,1,14,0,1031,1073
114373,32,1,14,0,1031,1063
114485,28,2,13,0,1031,1059
114830,32,1,14,0,1031,1063
115064,56,1,14,0,1031,1087
115078,41,2,14,0,1031,1072
115172,32,1,14,0,1031,1063
115601,32,1,14,0,1031,1063
115631,17,1,13,0,1031,1048
115979,32,1,14,0,1031,1063
116425,32,1,14,0,1031,1063
116644,17,1,13,0,1031,1048
116654,32,1,14,0,1031,1063
116925,35,1,14,0,1031,1066
117413,34,2,14,0,1031,1065
117640,32,1,14,0,1031,1063
117763,32,1,14,0,1031,1063
118125,32,1,14,0,1031,1063
118255,32,5,14,0,1031,1063
118485,32,1,14,0,1031,1063
119099,39,1,14,0,1031,1070
119250,17,1,13,0,1031,1048
119337,20,1,13,0,1031,1051
119464,17,1,13,0,1031,1048
119574,32,1,14,0,1031,1063
119587,17,1,13,0,1031,1048
119854,17,1,13,0,1031,1048
120150,20,1,13,0,1031,1051
121258,32,1,14,0,1031,1063
121340,17,1,13,0,1031,1048
121546,17,1,13,0,1031,1048
121550,17,1,13,0,1031,1048
121681,39,2,14,0,1031,1070
121722,17,1,13,0,1031,1048
121786,32,2,14,0,1031,1063
121797,17,1,13,0,1031,1048
121909,32,1,14,0,1031,1063
122261,22,3,13,0,1031,1053
123139,17,1,13,0,1031,1048
123156,17,1,13,0,1031,1048
123523,17,1,13,0,1031,1048
123560,17,1,13,0,1031,1048
123691,17,1,13,0,1031,1048
123770,32,1,14,0,1031,1063
123893,32,1,14,0,1031,1063
123968,17,1,13,0,1031,1048
124312,32,1,14,0,1031,1063
124316,17,1,13,0,1031,1048
124405,17,1,13,0,1031,1048
124874,32,2,14,0,1031,1063
125003,17,1,13,0,1031,1048
125018,32,1,14,0,1031,1063
125600,17,2,13,0,1031,1048
125724,17,2,13,0,1031,1048
126008,32,4,14,0,1031,1063
126350,17,1,13,0,1031,1048
127557,17,1,13,0,1031,1048
127791,32,1,14,0,1031,1063
127913,17,1,13,0,1031,1048
128220,32,1,14,0,1031,1063
128340,32,2,14,0,1031,1063
128355,17,1,13,0,1031,1048
128582,32,1,14,0,1031,1063
129215,17,1,13,0,1031,1048
129309,35,1,14,0,1031,1066
129659,32,1,14,0,1031,1063
129799,17,1,13,0,1031,1048
5787,42,2,14,0,1032,1074
6419,34,2,14,0,1032,1066
7281,8,5,13,0,1032,1040
9174,62,1,14,0,1032,1094
9836,47,7,14,0,1032,1079
10655,46,2,14,0,1032,1078
13391,43,5,14,0,1032,1075
13649,34,1,14,0,1032,1066
14888,55,2,14,0,1032,1087
15028,36,1,14,0,1032,1068
16625,34,1,14,0,1032,1066
17402,34,2,14,0,1032,1066
17703,62,1,14,0,1032,1094
17882,31,1,14,0,1032,1063
20829,8,1,13,0,1032,1040
20879,72,2,15,0,1032,1104
21913,25,1,13,1,1032,1057
22038,12,5,13,0,1032,1044
23459,34,1,14,0,1032,1066
23760,8,1,13,0,1032,1040
24096,45,1,14,0,1032,1077
27617,8,1,13,0,1032,1040
28844,8,1,13,0,1032,1040
31577,47,2,14,0,1032,1079
35003,8,1,13,0,1032,1040
35419,34,1,14,0,1032,1066
37382,39,4,14,0,1032,1071
38967,8,1,13,0,1032,1040
39605,31,5,14,0,1032,1063
46005,28,1,14,0,1032,1060
47323,19,1,13,0,1032,1051
50121,55,3,14,0,1032,1087
52803,47,2,14,0,1032,1079
54365,31,1,14,0,1032,1063
54880,8,1,13,0,1032,1040
54937,33,1,14,0,1032,1065
55139,13,2,13,0,1032,1045
58069,8,1,13,0,1032,1040
58251,42,1,14,0,1032,1074
58856,31,1,14,0,1032,1063
60726,8,1,13,0,1032,1040
62267,8,1,13,0,1032,1040
63177,8,1,13,0,1032,1040
64689,12,1,13,0,1032,1044
67309,8,1,13,0,1032,1040
67364,34,1,14,0,1032,1066
68422,42,1,14,0,1032,1074
69310,8,1,13,0,1032,1040
71220,8,1,13,0,1032,1040
71959,11,3,13,0,1032,1043
73513,50,2,14,0,1032,1082
74621,8,1,13,0,1032,1040
75178,16,1,13,0,1032,1048
76015,16,3,13,0,1032,1048
76233,8,1,13,0,1032,1040
76253,27,2,13,0,1032,1059
78190,8,1,13,0,1032,1040
78586,36,1,14,0,1032,1068
79682,12,1,13,0,1032,1044
79887,29,1,14,0,1032,1061
80584,8,1,13,0,1032,1040
81184,8,1,13,0,1032,1040
81914,8,1,13,0,1032,1040
82522,48,1,14,0,1032,1080
84787,47,1,14,0,1032,1079
87687,8,1,13,0,1032,1040
88685,47,2,14,0,1032,1079
91184,8,1,13,0,1032,1040
92391,28,2,14,0,1032,1060
92930,8,1,13,0,1032,1040
93307,8,1,13,0,1032,1040
96348,35,2,14,0,1032,1067
96718,43,1,14,0,1032,1075
97660,28,2,14,0,1032,1060
98927,14,1,13,0,1032,1046
103773,34,2,14,0,1032,1066
106528,47,1,14,0,1032,1079
107267,8,1,13,0,1032,1040
107380,47,1,14,0,1032,1079
107948,16,1,13,0,1032,1048
111302,34,4,14,0,1032,1066
112444,32,1,14,0,1032,1064
113803,31,2,14,0,1032,1063
115067,12,2,13,0,1032,1044
115340,21,1,13,0,1032,1053
115358,38,5,14,0,1032,1070
116513,17,1,13,0,1032,1049
120619,8,1,13,0,1032,1040
123119,30,1,14,0,1032,1062
123393,26,1,13,0,1032,1058
125269,34,4,14,0,1032,1066
127084,9,1,13,0,1032,1041
127683,37,4,14,0,1032,1069
128255,17,1,13,0,1032,1049
128385,42,1,14,0,1032,1074
10329,10,1,13,0,1033,1043
12253,10,1,13,0,1033,1043
14419,10,1,13,0,1033,1043
17500,11,6,13,0,1033,1044
26021,19,1,13,0,1033,1052
38993,18,3,13,0,1033,1051
48467,10,1,13,0,1033,1043
50650,10,7,13,0,1033,1043
55122,13,3,13,0,1033,1046
58857,10,1,13,0,1033,1043
71567,101,4,15,1,1033,1134
72813,10,2,13,0,1033,1043
85584,10,1,13,0,1033,1043
88301,8,1,13,0,1033,1041
98317,34,3,14,0,1033,1067
103045,10,1,13,0,1033,1043
124510,42,2,14,0,1033,1075
128313,10,1,13,0,1033,1043
128369,10,1,13,0,1033,1043
9588,17,2,13,0,1034,1051
12134,13,1,13,0,1034,1047
13144,52,1,14,0,1034,1086
15069,62,1,14,1,1034,1096
45497,16,1,13,0,1034,1050
51562,43,1,14,0,1034,1077
62694,43,2,14,0,1034,1077
75979,42,2,14,0,1034,1076
77363,17,2,13,0,1034,1051
84382,26,2,14,0,1034,1060
88705,17,1,13,0,1034,1051
104447,17,1,13,0,1034,1051
119705,32,2,14,0,1034,1066
120913,24,2,13,0,1034,1058
124042,43,3,14,0,1034,1077
10472,24,3,13,0,1035,1059
12517,33,3,14,0,1035,1068
16731,8,1,13,0,1035,1043
33717,22,1,13,0,1035,1057
34234,24,4,13,0,1035,1059
37976,6,1,13,0,1035,1041
52504,30,1,14,0,1035,1065
71074,14,1,13,0,1035,1049
72270,25,3,14,0,1035,1060
84161,24,2,13,0,1035,1059
99286,24,2,13,0,1035,1059
101716,25,2,14,0,1035,1060
102911,6,1,13,0,1035,1041
106663,6,2,13,0,1035,1041
115381,44,3,14,0,1035,1079
121923,6,1,13,0,1035,1041
123570,19,1,13,0,1035,1054
15022,15,1,13,0,1036,1051
15196,29,1,14,0,1036,1065
15408,15,2,13,0,1036,1051
17867,4,2,13,0,1036,1040
19861,12,1,13,0,1036,1048
21123,4,1,13,0,1036,1040
24662,22,2,13,0,1036,1058
25216,35,4,14,0,1036,1071
26559,39,1,14,0,1036,1075
28450,7,1,13,0,1036,1043
37223,43,1,14,0,1036,1079
41830,43,2,14,0,1036,1079
51085,77,1,15,1,1036,1113
64643,30,3,14,0,1036,1066
69250,4,4,13,0,1036,1040
71812,27,3,14,0,1036,1063
74697,27,4,14,0,1036,1063
77696,5,2,13,0,1036,1041
87508,6,4,13,0,1036,1042
99836,4,1,13,0,1036,1040
102234,36,1,14,0,1036,1072
107532,9,1,13,0,1036,1045
109715,13,1,13,0,1036,1049
110436,27,1,14,0,1036,1063
116828,15,4,13,0,1036,1051
117694,27,1,14,0,1036,1063
44005,26,1,14,0,1037,1063
51877,38,1,14,0,1037,1075
56687,32,2,14,0,1037,1069
99052,5,1,13,0,1037,1042
9558,36,6,14,0,1038,1074
14020,2,1,13,0,1038,1040
63092,25,1,14,1,1038,1063
107707,2,1,13,0,1038,1040
129403,2,1,13,0,1038,1040
26838,28,1,14,0,1039,1067
29716,20,1,13,0,1039,1059
55190,5,3,13,0,1039,1044
97402,32,1,14,0,1039,1071
97533,5,4,13,0,1039,1044
112094,24,5,14,1,1039,1063
129253,17,1,13,0,1039,1056
21468,33,2,14,0,1040,1073
68401,58,2,14,1,1040,1098
85333,98,1,15,1,1040,1138
105853,29,1,14,1,1040,1069
121919,58,2,14,1,1040,1098
28794,28,2,14,0,1041,1069
40673,30,1,14,0,1041,1071
7557,39,3,14,1,1042,1081
25062,3,1,13,0,1042,1045
34460,60,2,15,0,1042,1102
56336,28,4,14,0,1042,1070
62703,23,1,14,0,1042,1065
89961,24,1,14,0,1042,1066
101552,27,1,14,0,1042,1069
101672,24,2,14,0,1042,1066
113140,34,5,14,0,1042,1076
113871,27,1,14,0,1042,1069
116729,26,1,14,0,1042,1068
122699,21,2,14,0,1042,1063
128883,27,2,14,0,1042,1069
16744,36,3,14,1,1043,1079
70078,22,2,14,0,1043,1065
109566,27,1,14,1,1043,1070
17890,33,3,14,1,1044,1077
18820,17,2,14,0,1044,1061
47456,28,1,14,0,1044,1072
74809,34,1,14,1,1044,1078
128797,51,2,14,1,1044,1095
7768,21,1,14,0,1045,1066
23771,23,2,14,0,1045,1068
26476,13,1,13,0,1045,1058
28932,20,2,14,0,1045,1065
29938,20,1,14,0,1045,1065
31455,18,3,14,0,1045,1063
33806,20,4,14,0,1045,1065
34009,16,4,14,0,1045,1061
45168,23,2,14,0,1045,1068
45791,16,4,14,0,1045,1061
49181,26,1,14,0,1045,1071
50571,21,1,14,0,1045,1066
63253,16,3,14,0,1045,1061
72974,21,1,14,0,1045,1066
92741,21,1,14,0,1045,1066
97334,18,1,14,0,1045,1063
105239,32,1,14,1,1045,1077
128200,22,1,14,0,1045,1067
7113,5,1,13,0,1046,1051
30902,5,1,13,0,1046,1051
34109,5,1,13,0,1046,1051
48750,5,1,13,0,1046,1051
57047,7,8,13,0,1046,1053
81084,5,1,13,0,1046,1051
84677,5,1,13,0,1046,1051
85624,23,2,14,0,1046,1069
97055,17,4,14,0,1046,1063
97397,26,3,14,0,1046,1072
106454,5,1,13,0,1046,1051
122464,5,3,13,0,1046,1051
7511,9,1,13,0,1047,1056
9083,30,2,14,0,1047,1077
61989,19,2,14,0,1047,1066
65209,16,1,14,0,1047,1063
71113,9,1,13,0,1047,1056
93661,14,1,14,0,1047,1061
108405,8,1,13,1,1047,1055
113688,19,2,14,0,1047,1066
118866,19,3,14,0,1047,1066
121298,9,1,13,0,1047,1056
7597,12,1,14,0,1048,1060
14363,12,1,14,0,1048,1060
17591,18,1,14,0,1048,1066
18954,7,1,13,0,1048,1055
20893,30,1,14,0,1048,1078
32369,9,2,13,0,1048,1057
46741,7,1,13,0,1048,1055
46967,7,1,13,0,1048,1055
53776,7,1,13,0,1048,1055
74416,12,2,14,0,1048,1060
89124,27,3,14,1,1048,1075
92140,9,1,13,0,1048,1057
98772,9,1,13,0,1048,1057
105188,7,1,13,0,1048,1055
106669,9,1,13,0,1048,1057
118655,7,1,13,0,1048,1055
120393,9,1,13,0,1048,1057
124190,9,1,13,0,1048,1057
24563,10,4,13,0,1049,1059
36467,6,1,13,0,1049,1055
37487,207,5,18,1,1049,1256
48146,14,2,14,0,1049,1063
68180,10,4,13,0,1049,1059
78167,23,3,14,0,1049,1072
82456,10,5,13,0,1049,1059
115144,56,1,15,1,1049,1105
125213,15,2,14,0,1049,1064
21245,22,1,14,1,1050,1072
30090,23,1,14,1,1050,1073
46574,7,1,13,0,1050,1057
49179,11,1,14,0,1050,1061
77746,18,2,14,0,1050,1068
82263,13,1,14,0,1050,1063
90375,14,1,14,0,1050,1064
91053,14,1,14,0,1050,1064
91738,6,1,13,0,1050,1056
96464,18,3,14,0,1050,1068
128245,9,2,13,0,1050,1059
5724,20,1,14,0,1051,1071
45330,9,2,14,0,1051,1060
47549,13,1,14,0,1051,1064
54514,18,1,14,0,1051,1069
5775,24,1,14,0,1052,1076
56119,8,1,14,0,1052,1060
61729,6,4,13,0,1052,1058
37017,12,1,14,0,1053,1065
121732,56,3,15,1,1053,1109
35228,3,1,13,0,1054,1057
57809,43,3,14,1,1054,1097
76624,65,4,15,1,1054,1119
90198,3,1,13,0,1054,1057
127553,12,2,14,0,1054,1066
129589,77,1,15,1,1054,1131
7113,12,2,14,0,1055,1067
8353,11,1,14,0,1055,1066
30902,12,2,14,0,1055,1067
31056,12,2,14,0,1055,1067
34109,12,2,14,0,1055,1067
45497,46,2,15,0,1055,1101
48750,12,2,14,0,1055,1067
52762,17,1,14,0,1055,1072
53725,23,2,14,0,1055,1078
55760,23,1,14,0,1055,1078
64513,16,1,14,0,1055,1071
78546,9,1,14,0,1055,1064
81084,12,2,14,0,1055,1067
82612,22,1,14,0,1055,1077
84677,12,2,14,0,1055,1067
85465,9,1,14,0,1055,1064
90441,17,1,14,0,1055,1072
106454,12,2,14,0,1055,1067
112931,13,1,14,0,1055,1068
114840,26,1,14,0,1055,1081
116513,24,2,14,0,1055,1079
122464,12,4,14,0,1055,1067
128255,24,2,14,0,1055,1079
8489,7,1,14,0,1056,1063
38708,16,1,14,0,1056,1072
50238,16,1,14,0,1056,1072
71054,21,3,14,0,1056,1077
85300,13,1,14,0,1056,1069
87035,73,2,15,1,1056,1129
88705,24,2,14,0,1056,1080
102458,7,1,14,0,1056,1063
109715,23,2,14,0,1056,1079
8884,22,3,14,0,1057,1079
9588,11,3,14,0,1057,1068
14991,21,3,14,0,1057,1078
28450,16,2,14,0,1057,1073
29991,6,1,14,0,1057,1063
39324,134,3,17,0,1057,1191
42341,19,4,14,0,1057,1076
52900,17,3,14,1,1057,1074
77363,11,3,14,0,1057,1068
77907,31,2,14,0,1057,1088
104447,23,2,14,0,1057,1080
104453,14,5,14,0,1057,1071
104624,47,4,15,0,1057,1104
110727,22,4,14,0,1057,1079
111523,11,4,14,0,1057,1068
115340,10,2,14,0,1057,1067
123955,20,1,14,0,1057,1077
14020,14,2,14,0,1058,1072
24421,7,3,14,0,1058,1065
24727,53,2,15,0,1058,1111
24957,7,9,14,0,1058,1065
29160,18,1,14,0,1058,1076
38977,7,5,14,0,1058,1065
45151,7,3,14,0,1058,1065
45616,20,2,14,0,1058,1078
46553,4,1,14,0,1058,1062
60084,65,1,15,1,1058,1123
65690,7,5,14,0,1058,1065
69151,51,2,15,1,1058,1109
70813,20,4,14,0,1058,1078
90266,7,3,14,0,1058,1065
107707,14,2,14,0,1058,1072
111910,7,4,14,0,1058,1065
129403,14,2,14,0,1058,1072
9365,11,4,14,1,1059,1070
15206,19,1,14,0,1059,1078
18954,11,2,14,0,1059,1070
26563,45,2,15,0,1059,1104
32369,11,3,14,0,1059,1070
34816,10,1,14,0,1059,1069
35021,20,3,14,0,1059,1079
36467,11,2,14,0,1059,1070
37026,14,2,14,0,1059,1073
44121,20,3,14,0,1059,1079
46741,11,2,14,0,1059,1070
46967,11,2,14,0,1059,1070
53776,11,2,14,0,1059,1070
55358,6,1,14,0,1059,1065
55747,18,5,14,0,1059,1077
58392,163,3,17,1,1059,1222
59468,3,4,14,0,1059,1062
71840,18,5,14,0,1059,1077
75178,28,2,14,0,1059,1087
87698,3,1,14,0,1059,1062
92140,11,2,14,0,1059,1070
97042,18,5,14,0,1059,1077
97840,18,3,14,0,1059,1077
98772,11,2,14,0,1059,1070
99041,35,1,14,0,1059,1094
105188,11,2,14,0,1059,1070
106669,11,2,14,0,1059,1070
115048,3,7,14,0,1059,1062
116841,14,1,14,0,1059,1073
118655,11,2,14,0,1059,1070
120393,11,2,14,0,1059,1070
121025,3,4,14,0,1059,1062
124190,11,2,14,0,1059,1070
124268,7,4,14,0,1059,1066
17521,9,4,14,0,1060,1069
20026,10,1,14,0,1060,1070
22170,10,1,14,0,1060,1070
22195,10,2,14,0,1060,1070
29020,27,1,14,0,1060,1087
34062,10,1,14,0,1060,1070
61078,69,2,15,1,1060,1129
66645,10,3,14,0,1060,1070
83713,26,1,14,0,1060,1086
85334,17,2,14,0,1060,1077
85456,20,1,14,0,1060,1080
101622,10,1,14,0,1060,1070
115622,12,1,14,0,1060,1072
16731,21,2,14,0,1061,1082
26577,21,2,14,0,1061,1082
33333,20,1,14,0,1061,1081
43491,10,1,14,0,1061,1071
64255,20,1,14,0,1061,1081
64599,29,1,14,0,1061,1090
64689,29,2,14,0,1061,1090
79682,21,2,14,0,1061,1082
100752,147,3,17,0,1061,1208
102820,130,3,17,0,1061,1191
106609,10,1,14,0,1061,1071
108056,21,1,14,0,1061,1082
115631,10,2,14,0,1061,1071
126617,22,2,14,0,1061,1083
6143,45,2,15,0,1062,1107
25062,4,2,14,0,1062,1066
34218,14,1,14,0,1062,1076
42425,14,1,14,0,1062,1076
50224,110,1,16,1,1062,1172
68417,8,1,14,0,1062,1070
69275,8,1,14,0,1062,1070
77151,8,1,14,0,1062,1070
83258,5,2,14,0,1062,1067
92930,4,2,14,0,1062,1066
98602,8,1,14,0,1062,1070
99048,8,2,14,0,1062,1070
101227,8,1,14,0,1062,1070
104636,25,1,14,0,1062,1087
11632,138,7,17,0,1063,1201
22290,16,1,14,0,1063,1079
28723,24,2,14,0,1063,1087
39683,20,1,14,0,1063,1083
48809,13,1,14,0,1063,1076
65711,4,4,14,0,1063,1067
71074,13,2,14,0,1063,1076
71113,5,2,14,0,1063,1068
75902,3,1,14,0,1063,1066
86308,44,2,15,0,1063,1107
93346,3,1,14,0,1063,1066
101142,4,1,14,0,1063,1067
104154,13,1,14,0,1063,1076
104232,69,2,15,1,1063,1132
105354,16,1,14,0,1063,1079
17500,15,7,14,0,1064,1079
19861,15,2,14,0,1064,1079
20708,40,1,15,0,1064,1104
44525,22,1,14,0,1064,1086
56944,61,1,15,0,1064,1125
59849,40,1,15,0,1064,1104
76271,26,1,14,0,1064,1090
77696,31,3,14,0,1064,1095
81213,39,1,15,0,1064,1103
82889,41,1,15,1,1064,1105
87508,11,5,14,0,1064,1075
87816,14,4,14,0,1064,1078
90905,14,3,14,0,1064,1078
94470,16,1,14,0,1064,1080
99169,15,1,14,0,1064,1079
112609,62,3,15,1,1064,1126
115067,14,3,14,0,1064,1078
120574,16,1,14,0,1064,1080
5656,14,3,14,0,1065,1079
6118,14,2,14,0,1065,1079
38608,25,1,14,0,1065,1090
38993,10,4,14,0,1065,1075
48599,25,1,14,0,1065,1090
48945,25,1,14,0,1065,1090
52767,14,3,14,0,1065,1079
78176,16,1,14,0,1065,1081
106663,13,3,14,0,1065,1078
12134,13,2,14,0,1066,1079
17780,17,1,14,0,1066,1083
22893,17,1,14,0,1066,1083
37976,13,2,14,0,1066,1079
40311,44,3,15,1,1066,1110
52546,38,1,15,0,1066,1104
54843,18,1,14,0,1066,1084
55139,38,3,15,0,1066,1104
69102,20,1,14,0,1066,1086
72789,6,4,14,0,1066,1072
83334,121,2,17,0,1066,1187
99514,28,1,14,0,1066,1094
104579,20,1,14,0,1066,1086
108043,20,1,14,0,1066,1086
127088,20,1,14,0,1066,1086
18685,59,1,15,1,1067,1126
21123,11,2,14,0,1067,1078
34721,38,1,15,1,1067,1105
40079,39,1,15,1,1067,1106
52156,5,3,14,0,1067,1072
89092,19,2,14,0,1067,1086
102911,20,2,14,0,1067,1087
127691,30,2,14,0,1067,1097
10375,14,1,14,0,1068,1082
20798,18,1,14,0,1068,1086
29842,18,1,14,0,1068,1086
47323,32,2,15,0,1068,1100
70209,17,2,14,0,1068,1085
72813,36,3,15,0,1068,1104
78512,16,2,14,0,1068,1084
79697,11,1,14,0,1068,1079
88301,35,2,15,0,1068,1103
96534,11,2,14,0,1068,1079
111198,16,6,14,0,1068,1084
121856,11,1,14,0,1068,1079
122916,19,3,14,0,1068,1087
17867,13,3,14,0,1069,1082
30168,56,3,15,1,1069,1125
47439,11,4,14,0,1069,1080
69110,35,1,15,0,1069,1104
71812,19,4,14,0,1069,1088
82640,54,1,15,1,1069,1123
94134,10,1,14,0,1069,1079
101692,11,1,14,0,1069,1080
109552,19,2,14,0,1069,1088
120483,19,1,14,0,1069,1088
20103,9,1,14,1,1070,1079
40335,9,2,14,0,1070,1079
46232,28,3,14,0,1070,1098
54974,9,5,14,0,1070,1079
67636,32,3,15,1,1070,1102
75442,10,2,14,0,1070,1080
84469,9,1,14,0,1070,1079
115136,18,2,14,0,1070,1088
117776,34,1,15,0,1070,1104
13505,14,1,14,0,1071,1085
15603,16,1,14,0,1071,1087
25549,8,2,14,0,1071,1079
26750,8,2,14,0,1071,1079
37121,12,1,14,0,1071,1083
75471,14,1,14,0,1071,1085
97949,11,1,14,0,1071,1082
110275,40,1,15,0,1071,1111
34827,11,3,14,0,1072,1083
67187,32,3,15,1,1072,1104
72214,37,3,15,0,1072,1109
9067,10,1,14,0,1073,1083
16555,8,1,14,0,1073,1081
17711,3,1,14,0,1073,1076
18854,10,1,14,0,1073,1083
30885,10,1,14,0,1073,1083
46582,10,1,14,0,1073,1083
49860,10,1,14,0,1073,1083
51361,8,1,14,0,1073,1081
54353,10,1,14,0,1073,1083
60062,8,1,14,0,1073,1081
62539,26,1,14,0,1073,1099
67370,10,1,14,0,1073,1083
73047,77,1,16,0,1073,1150
77154,10,1,14,0,1073,1083
81956,8,3,14,0,1073,1081
87422,8,1,14,0,1073,1081
88828,10,1,14,0,1073,1083
93872,77,1,16,0,1073,1150
98630,8,1,14,0,1073,1081
107863,10,1,14,0,1073,1083
107995,8,4,14,0,1073,1081
112600,10,1,14,0,1073,1083
128914,15,2,14,0,1073,1088
37010,6,1,14,0,1074,1080
47076,6,1,14,0,1074,1080
18209,34,3,15,0,1075,1109
28898,4,1,14,0,1075,1079
8829,107,1,17,0,1076,1183
26877,33,2,15,0,1076,1109
40675,71,1,16,0,1076,1147
60053,71,1,16,0,1076,1147
69268,14,1,14,0,1076,1090
74606,30,5,15,0,1076,1106
78101,36,1,15,0,1076,1112
109272,12,4,14,0,1076,1088
121434,58,6,15,0,1076,1134
15050,22,3,14,0,1077,1099
16356,33,3,15,0,1077,1110
20080,39,5,15,1,1077,1116
58221,59,1,15,1,1077,1136
69150,13,1,14,0,1077,1090
72250,34,2,15,0,1077,1111
90424,53,3,15,1,1077,1130
14925,10,1,14,0,1078,1088
16886,9,1,14,0,1078,1087
38908,10,2,14,0,1078,1088
40779,16,5,14,0,1078,1094
61033,103,7,17,1,1078,1181
65492,9,1,14,0,1078,1087
104194,10,2,14,0,1078,1088
115432,12,1,14,0,1078,1090
15644,59,2,15,1,1079,1138
28838,21,1,15,0,1079,1100
31095,109,2,17,0,1079,1188
45146,8,3,14,0,1079,1087
51484,23,1,15,0,1079,1102
67308,24,2,15,0,1079,1103
84046,24,2,15,1,1079,1103
84163,11,2,14,0,1079,1090
85504,29,2,15,1,1079,1108
9208,7,2,14,0,1080,1087
9365,14,5,14,1,1080,1094
18026,20,2,15,0,1080,1100
27784,19,2,14,0,1080,1099
40808,23,2,15,0,1080,1103
41143,23,2,15,0,1080,1103
42516,24,3,15,0,1080,1104
47284,7,7,14,0,1080,1087
53314,56,2,15,0,1080,1136
60947,19,3,14,0,1080,1099
69754,7,7,14,0,1080,1087
71102,23,2,15,0,1080,1103
71698,7,6,14,0,1080,1087
77395,7,2,14,0,1080,1087
83050,7,4,14,0,1080,1087
86936,111,3,17,0,1080,1191
90071,7,1,14,0,1080,1087
93396,7,1,14,0,1080,1087
97445,14,2,14,0,1080,1094
101485,26,1,15,0,1080,1106
101824,7,6,14,0,1080,1087
104062,13,2,14,0,1080,1093
108375,7,2,14,0,1080,1087
50650,19,8,15,0,1081,1100
59319,6,3,14,0,1081,1087
16719,8,2,14,0,1082,1090
51848,4,1,14,0,1082,1086
52146,4,2,14,0,1082,1086
53725,4,3,14,0,1082,1086
55011,18,3,15,0,1082,1100
55225,85,2,16,0,1082,1167
62305,6,3,14,0,1082,1088
77785,16,4,14,1,1082,1098
86479,73,1,16,1,1082,1155
92550,16,1,14,1,1082,1098
112931,4,2,14,0,1082,1086
121923,4,2,14,0,1082,1086
122336,6,3,14,0,1082,1088
16237,3,3,14,0,1083,1086
33203,20,3,15,1,1083,1103
44549,14,4,14,0,1083,1097
92065,49,1,15,1,1083,1132
97956,5,1,14,0,1083,1088
100536,26,3,15,0,1083,1109
123880,7,4,14,0,1083,1090
17290,103,4,17,1,1084,1187
46076,64,1,16,0,1084,1148
48917,26,1,15,1,1084,1110
62283,20,1,15,0,1084,1104
69619,20,2,15,1,1084,1104
78176,10,2,14,0,1084,1094
80597,42,4,15,1,1084,1126
97660,13,3,14,0,1084,1097
104453,14,6,14,0,1084,1098
126327,4,3,14,0,1084,1088
6145,15,2,15,1,1085,1100
23659,17,1,15,1,1085,1102
28203,12,1,14,0,1085,1097
49802,24,1,15,1,1085,1109
49831,10,2,14,1,1085,1095
64375,12,1,14,0,1085,1097
68488,12,1,14,0,1085,1097
68660,12,1,14,0,1085,1097
69392,12,2,14,0,1085,1097
73513,79,3,16,0,1085,1164
74922,32,6,15,1,1085,1117
78774,12,2,14,0,1085,1097
82522,10,2,14,0,1085,1095
84298,12,1,14,0,1085,1097
105632,146,1,18,0,1085,1231
105663,72,1,16,1,1085,1157
107640,140,4,18,0,1085,1225
116513,10,3,14,0,1085,1095
120370,15,1,15,0,1085,1100
120574,9,2,14,0,1085,1094
128255,10,3,14,0,1085,1095
6157,14,1,15,0,1086,1100
11788,45,2,15,1,1086,1131
22153,8,5,14,0,1086,1094
28898,9,2,14,0,1086,1095
55608,8,1,14,0,1086,1094
72215,23,1,15,1,1086,1109
90905,8,4,14,0,1086,1094
109762,8,5,14,0,1086,1094
113140,8,6,14,0,1086,1094
123922,40,1,15,1,1086,1126
127705,12,3,14,0,1086,1098
5724,50,2,15,0,1087,1137
26021,5,2,14,0,1087,1092
46802,18,1,15,1,1087,1105
55397,8,5,14,0,1087,1095
97703,8,3,14,0,1087,1095
127084,12,2,14,0,1087,1099
9265,20,1,15,0,1088,1108
9836,7,8,14,0,1088,1095
10834,6,1,14,0,1088,1094
16012,6,2,14,0,1088,1094
17867,21,4,15,0,1088,1109
18813,77,1,16,1,1088,1165
19861,6,3,14,0,1088,1094
24862,28,1,15,1,1088,1116
25062,6,3,14,0,1088,1094
27736,6,2,14,0,1088,1094
34014,6,1,14,0,1088,1094
41121,6,2,14,0,1088,1094
44006,6,1,14,0,1088,1094
44121,6,4,14,0,1088,1094
70222,5,2,14,0,1088,1093
75825,6,1,14,0,1088,1094
79697,6,2,14,0,1088,1094
79886,5,10,14,0,1088,1093
83797,6,1,14,0,1088,1094
85473,6,1,14,0,1088,1094
100550,6,3,14,0,1088,1094
102208,39,4,15,1,1088,1127
106663,6,4,14,0,1088,1094
111690,6,1,14,0,1088,1094
115381,14,4,15,0,1088,1102
123119,3,2,14,0,1088,1091
126101,6,1,14,0,1088,1094
7768,6,2,14,0,1089,1095
11763,4,2,14,0,1089,1093
12622,4,2,14,0,1089,1093
21123,4,3,14,0,1089,1093
29870,4,1,14,0,1089,1093
32235,4,1,14,0,1089,1093
32343,5,2,14,0,1089,1094
35366,29,1,15,1,1089,1118
43949,4,4,14,0,1089,1093
54462,15,1,15,1,1089,1104
69977,6,3,14,0,1089,1095
71220,4,2,14,0,1089,1093
93858,4,4,14,0,1089,1093
106374,29,1,15,1,1089,1118
116925,3,2,14,0,1089,1092
127455,4,6,14,0,1089,1093
8335,21,2,15,1,1090,1111
50169,90,2,17,1,1090,1180
81412,94,5,17,0,1090,1184
97074,2,2,14,0,1090,1092
51562,3,2,14,1,1091,1094
99412,75,1,16,0,1091,1166
58320,43,4,15,1,1092,1135
53117,40,1,15,1,1094,1134
71812,93,5,17,0,1094,1187
86304,21,1,15,1,1094,1115
94572,69,1,16,0,1094,1163
13767,7,7,15,0,1095,1102
20103,25,2,15,1,1095,1120
34827,5,4,15,0,1095,1100
75442,69,3,16,0,1095,1164
93396,183,2,19,0,1095,1278
120483,8,2,15,0,1095,1103
128914,92,3,17,0,1095,1187
53050,81,4,16,1,1096,1177
54974,5,6,15,0,1096,1101
69754,14,8,15,0,1096,1110
128289,68,3,16,0,1096,1164
45203,35,3,15,1,1097,1132
47284,93,8,17,0,1097,1190
51562,17,3,15,1,1097,1114
71698,103,7,17,0,1097,1200
9836,11,9,15,0,1099,1110
11089,33,1,15,1,1099,1132
43774,8,1,15,0,1099,1107
77907,23,3,15,0,1099,1122
46539,92,1,17,0,1100,1192
92741,140,2,18,0,1100,1240
125611,86,6,17,0,1100,1186
40779,8,6,15,0,1101,1109
63790,71,4,16,1,1101,1172
77696,8,4,15,0,1101,1109
107180,48,5,16,0,1101,1149
111523,165,5,19,0,1101,1266
61729,150,5,18,0,1102,1252
84149,19,1,15,0,1102,1121
90914,22,1,15,0,1102,1124
109272,81,5,17,0,1102,1183
27843,70,3,16,0,1103,1173
122916,19,4,15,0,1103,1122
63899,15,1,15,0,1104,1119
64880,145,4,18,1,1104,1249
83050,8,5,15,0,1104,1112
90905,11,5,15,0,1104,1115
101824,10,7,15,0,1104,1114
50418,97,1,17,0,1105,1202
110127,68,1,16,0,1105,1173
123387,58,1,16,0,1105,1163
6166,96,3,17,0,1106,1202
6612,95,1,17,1,1106,1201
9169,10,5,15,0,1106,1116
12785,14,4,15,0,1106,1120
17588,18,4,15,0,1106,1124
18085,85,1,17,0,1106,1191
37010,19,2,15,0,1106,1125
51300,85,2,17,0,1106,1191
51361,82,2,17,0,1106,1188
61715,18,1,15,0,1106,1124
79479,84,1,17,0,1106,1190
80604,14,3,15,0,1106,1120
101700,84,6,17,0,1106,1190
127932,106,1,17,0,1106,1212
128425,80,1,17,0,1106,1186
18223,83,4,17,0,1107,1190
47484,21,1,15,1,1107,1128
50049,83,1,17,0,1107,1190
66277,19,1,15,0,1107,1126
69749,145,1,18,0,1107,1252
70536,83,5,17,0,1107,1190
74854,84,1,17,0,1107,1191
97402,74,2,17,0,1107,1181
103032,83,2,17,0,1107,1190
107995,96,5,17,1,1107,1203
117027,83,1,17,0,1107,1190
119815,85,1,17,0,1107,1192
123254,83,1,17,0,1107,1190
123880,19,5,15,0,1107,1126
18805,80,4,17,1,1108,1188
21255,42,3,16,0,1108,1150
32245,42,2,16,0,1108,1150
48945,16,2,15,0,1108,1124
51847,14,1,15,0,1108,1122
66776,95,2,17,0,1108,1203
90829,93,3,17,0,1108,1201
110824,14,6,15,0,1108,1122
115381,86,5,17,0,1108,1194
124674,14,1,15,0,1108,1122
6367,12,1,15,0,1109,1121
11795,77,1,17,0,1109,1186
13767,13,8,15,0,1109,1122
14756,77,1,17,0,1109,1186
15050,88,4,17,0,1109,1197
15105,81,1,17,0,1109,1190
16808,77,1,17,0,1109,1186
17113,13,1,15,0,1109,1122
21986,12,2,15,0,1109,1121
35360,9,4,15,0,1109,1118
35996,77,1,17,0,1109,1186
36077,74,1,17,0,1109,1183
44121,55,5,16,0,1109,1164
46509,13,4,15,0,1109,1122
52259,14,2,15,0,1109,1123
53513,7,1,15,0,1109,1116
54193,14,1,15,0,1109,1123
55310,13,1,15,0,1109,1122
56037,77,1,17,0,1109,1186
59018,13,2,15,0,1109,1122
62360,10,5,15,0,1109,1119
68268,13,4,15,0,1109,1122
73961,81,1,17,0,1109,1190
79656,78,1,17,0,1109,1187
79987,77,1,17,0,1109,1186
80585,15,1,15,0,1109,1124
80721,78,1,17,0,1109,1187
81066,77,1,17,0,1109,1186
94125,13,1,15,0,1109,1122
95762,13,1,15,0,1109,1122
97444,11,2,15,0,1109,1120
98879,13,1,15,0,1109,1122
102159,74,1,17,0,1109,1183
105511,13,3,15,0,1109,1122
109228,77,1,17,0,1109,1186
109715,79,3,17,0,1109,1188
113140,15,7,15,0,1109,1124
126332,77,1,17,0,1109,1186
8189,114,2,17,1,1110,1224
11613,11,1,15,0,1110,1121
11955,20,2,15,0,1110,1130
14219,77,4,17,0,1110,1187
15077,73,7,17,0,1110,1183
17421,77,1,17,0,1110,1187
21467,77,1,17,0,1110,1187
21705,77,2,17,0,1110,1187
22076,11,1,15,0,1110,1121
25062,13,4,15,0,1110,1123
26623,13,2,15,0,1110,1123
33178,77,3,17,0,1110,1187
34884,79,1,17,0,1110,1189
37382,5,5,15,0,1110,1115
42633,74,1,17,0,1110,1184
43156,77,1,17,0,1110,1187
44409,14,1,15,0,1110,1124
45146,78,4,17,0,1110,1188
48912,74,1,17,0,1110,1184
51424,74,1,17,0,1110,1184
54974,104,7,17,0,1110,1214
55874,77,1,17,0,1110,1187
58626,77,1,17,0,1110,1187
62469,77,1,17,0,1110,1187
64639,74,1,17,0,1110,1184
64857,79,1,17,0,1110,1189
71107,77,1,17,0,1110,1187
72636,77,1,17,0,1110,1187
74866,80,1,17,0,1110,1190
76949,77,2,17,0,1110,1187
77377,77,1,17,0,1110,1187
82432,115,7,18,0,1110,1225
83002,79,1,17,0,1110,1189
89702,77,1,17,0,1110,1187
90071,11,2,15,0,1110,1121
93201,9,1,15,0,1110,1119
94571,74,1,17,0,1110,1184
95868,77,1,17,0,1110,1187
98000,62,1,16,0,1110,1172
98300,77,1,17,0,1110,1187
100409,77,1,17,0,1110,1187
100953,73,1,17,0,1110,1183
101672,10,3,15,0,1110,1120
102296,77,1,17,0,1110,1187
106396,5,4,15,0,1110,1115
106949,14,1,15,0,1110,1124
108204,73,1,17,0,1110,1183
110461,74,1,17,0,1110,1184
110621,74,1,17,0,1110,1184
114998,142,1,18,0,1110,1252
115565,115,1,18,0,1110,1225
116990,74,1,17,0,1110,1184
118164,70,2,17,0,1110,1180
124193,92,2,17,0,1110,1202
129093,77,1,17,0,1110,1187
15074,10,2,15,0,1111,1121
17311,73,3,17,0,1111,1184
18026,10,3,15,0,1111,1121
25549,3,3,15,0,1111,1114
29842,11,2,15,0,1111,1122
34460,13,3,15,0,1111,1124
42947,70,1,17,0,1111,1181
64599,11,2,15,0,1111,1122
97042,8,6,15,0,1111,1119
116729,40,2,16,0,1111,1151
119007,10,2,15,0,1111,1121
121995,76,1,17,0,1111,1187
122336,13,4,15,0,1111,1124
122634,76,1,17,0,1111,1187
9208,7,3,15,0,1112,1119
12517,10,4,15,0,1112,1122
20798,7,2,15,0,1112,1119
20893,12,2,15,0,1112,1124
21913,76,2,17,1,1112,1188
28933,7,1,15,0,1112,1119
38908,10,3,15,0,1112,1122
43509,35,3,16,0,1112,1147
59319,7,4,15,0,1112,1119
60813,7,1,15,0,1112,1119
62492,86,1,17,0,1112,1198
78167,5,4,15,0,1112,1117
119004,10,3,15,0,1112,1122
120483,68,3,17,0,1112,1180
124510,52,3,16,0,1112,1164
127691,8,3,15,0,1112,1120
23771,8,3,15,0,1113,1121
31970,74,3,17,1,1113,1187
43330,34,2,16,0,1113,1147
45168,8,3,15,0,1113,1121
62703,103,2,17,0,1113,1216
85456,7,2,15,0,1113,1120
113065,16,1,15,0,1113,1129
12379,33,4,16,0,1114,1147
13306,5,4,15,0,1114,1119
35458,49,2,16,0,1114,1163
48836,7,3,15,0,1114,1121
63059,73,1,17,0,1114,1187
63163,71,1,17,0,1114,1185
63393,18,2,15,0,1114,1132
64200,73,1,17,0,1114,1187
79274,73,1,17,0,1114,1187
82263,13,2,15,0,1114,1127
95397,49,4,16,0,1114,1163
105095,7,3,15,0,1114,1121
89124,37,4,16,1,1115,1152
98105,47,3,16,1,1115,1162
128797,72,3,17,1,1115,1187
129092,6,1,15,0,1115,1121
74809,62,2,16,1,1116,1178
80758,86,2,17,0,1116,1202
120312,50,1,16,0,1116,1166
11849,33,1,16,0,1117,1150
21542,50,1,16,0,1117,1167
35982,52,1,16,0,1117,1169
37541,53,1,16,1,1117,1170
49884,52,1,16,0,1117,1169
55553,50,1,16,0,1117,1167
128432,50,1,16,0,1117,1167
24317,15,1,15,0,1118,1133
24862,10,2,15,1,1118,1128
39123,33,1,16,0,1118,1151
57809,60,4,16,1,1118,1178
67280,82,4,17,0,1118,1200
81512,48,1,16,0,1118,1166
103532,47,1,16,0,1118,1165
112799,48,1,16,0,1118,1166
112813,33,4,16,0,1118,1151
122087,31,1,16,0,1118,1149
8866,46,1,16,0,1119,1165
14553,46,1,16,0,1119,1165
28689,67,1,17,0,1119,1186
30845,46,1,16,0,1119,1165
37223,28,2,16,0,1119,1147
43675,33,1,16,0,1119,1152
44084,46,1,16,0,1119,1165
44406,46,1,16,0,1119,1165
44966,20,1,15,0,1119,1139
45162,33,3,16,0,1119,1152
45329,67,1,17,0,1119,1186
50919,72,1,17,0,1119,1191
57077,48,1,16,0,1119,1167
62305,68,4,17,0,1119,1187
66272,46,1,16,0,1119,1165
74182,123,1,18,0,1119,1242
89734,31,1,16,0,1119,1150
91234,20,1,15,0,1119,1139
95118,46,1,16,0,1119,1165
96442,48,1,16,0,1119,1167
100031,46,1,16,0,1119,1165
105239,145,2,19,1,1119,1264
107720,66,1,17,0,1119,1185
111478,65,1,17,0,1119,1184
122522,123,1,18,0,1119,1242
6295,45,1,16,0,1120,1165
6737,46,1,16,0,1120,1166
13454,43,2,16,0,1120,1163
16610,46,1,16,0,1120,1166
18209,58,4,16,0,1120,1178
20638,13,1,15,0,1120,1133
22375,46,1,16,0,1120,1166
24771,46,1,16,0,1120,1166
24821,43,1,16,0,1120,1163
26407,13,6,15,0,1120,1133
26749,49,1,16,0,1120,1169
28790,46,2,16,0,1120,1166
30497,46,1,16,0,1120,1166
34232,46,1,16,0,1120,1166
34827,46,5,16,0,1120,1166
41830,27,3,16,0,1120,1147
42631,46,5,16,0,1120,1166
43949,46,5,16,0,1120,1166
45923,46,1,16,0,1120,1166
49003,51,1,16,0,1120,1171
49136,131,1,18,0,1120,1251
49164,43,2,16,0,1120,1163
49335,46,1,16,0,1120,1166
51010,106,1,18,0,1120,1226
51848,46,2,16,0,1120,1166
52415,46,1,16,0,1120,1166
54709,123,1,18,0,1120,1243
54723,46,1,16,0,1120,1166
55760,43,2,16,0,1120,1163
67106,45,1,16,0,1120,1165
69009,46,4,16,0,1120,1166
69986,14,1,15,0,1120,1134
70483,46,1,16,0,1120,1166
71057,46,1,16,0,1120,1166
73904,45,1,16,0,1120,1165
77030,46,1,16,0,1120,1166
77051,68,1,17,0,1120,1188
77191,120,2,18,0,1120,1240
78771,46,1,16,0,1120,1166
80940,68,3,17,0,1120,1188
81329,31,6,16,0,1120,1151
81923,43,2,16,0,1120,1163
86649,46,1,16,0,1120,1166
90868,85,2,17,0,1120,1205
91738,72,2,17,0,1120,1192
94992,46,1,16,0,1120,1166
103295,71,1,17,0,1120,1191
104624,68,5,17,0,1120,1188
104806,46,1,16,0,1120,1166
108992,46,2,16,0,1120,1166
110275,46,2,16,0,1120,1166
110788,44,1,16,0,1120,1164
112455,46,1,16,0,1120,1166
113219,63,1,17,0,1120,1183
114628,46,1,16,0,1120,1166
115067,49,4,16,0,1120,1169
121636,46,1,16,0,1120,1166
121919,43,3,16,0,1120,1163
123048,46,1,16,0,1120,1166
123931,43,1,16,0,1120,1163
125478,46,1,16,0,1120,1166
126327,69,4,17,0,1120,1189
127031,46,1,16,0,1120,1166
128039,46,1,16,0,1120,1166
5775,45,2,16,0,1121,1166
6143,45,3,16,0,1121,1166
6686,39,1,16,0,1121,1160
8264,67,1,17,0,1121,1188
15930,45,1,16,0,1121,1166
16356,59,4,17,0,1121,1180
17739,45,1,16,0,1121,1166
21245,51,2,16,1,1121,1172
25549,64,4,17,0,1121,1185
26577,31,3,16,0,1121,1152
27068,42,3,16,0,1121,1163
28657,65,2,17,0,1121,1186
51422,41,1,16,0,1121,1162
65711,45,5,16,0,1121,1166
68660,69,2,17,0,1121,1190
77015,8,1,15,0,1121,1129
79227,51,1,16,1,1121,1172
97378,38,1,16,0,1121,1159
100496,62,1,17,0,1121,1183
101824,79,8,17,0,1121,1200
104544,60,1,17,0,1121,1181
111198,68,7,17,0,1121,1189
119516,53,3,16,0,1121,1174
120521,51,1,16,0,1121,1172
7907,40,1,16,0,1122,1162
7979,40,1,16,0,1122,1162
8185,40,1,16,0,1122,1162
9263,75,8,17,0,1122,1197
15394,58,2,17,0,1122,1180
20115,12,1,15,0,1122,1134
22285,9,3,15,0,1122,1131
22385,11,4,15,0,1122,1133
24727,43,3,16,0,1122,1165
26026,72,2,17,0,1122,1194
26027,75,8,17,0,1122,1197
26563,69,3,17,0,1122,1191
26750,63,3,17,0,1122,1185
27021,46,1,16,0,1122,1168
28493,48,1,16,0,1122,1170
29468,41,1,16,0,1122,1163
30773,40,1,16,0,1122,1162
31190,25,1,16,0,1122,1147
31643,76,6,17,0,1122,1198
33264,41,1,16,0,1122,1163
33975,40,1,16,0,1122,1162
34442,40,1,16,0,1122,1162
36343,40,1,16,0,1122,1162
37382,9,6,15,0,1122,1131
38963,12,1,15,0,1122,1134
39306,39,1,16,0,1122,1161
43283,40,1,16,0,1122,1162
44755,40,1,16,0,1122,1162
44930,8,2,15,0,1122,1130
44977,40,1,16,0,1122,1162
46602,12,1,15,0,1122,1134
48040,43,1,16,0,1122,1165
53263,40,1,16,0,1122,1162
54659,58,6,17,0,1122,1180
55357,40,1,16,0,1122,1162
60108,52,1,16,0,1122,1174
60326,47,1,16,0,1122,1169
61095,46,1,16,0,1122,1168
62264,49,1,16,0,1122,1171
62450,47,1,16,0,1122,1169
64566,40,1,16,0,1122,1162
65026,40,1,16,0,1122,1162
65821,27,2,16,0,1122,1149
66322,40,1,16,0,1122,1162
68319,40,1,16,0,1122,1162
69754,58,9,17,0,1122,1180
72994,40,1,16,0,1122,1162
75320,72,1,17,0,1122,1194
75652,40,1,16,0,1122,1162
75926,47,1,16,0,1122,1169
76239,12,1,15,0,1122,1134
78101,61,2,17,0,1122,1183
80029,40,1,16,0,1122,1162
80823,40,1,16,0,1122,1162
83050,13,6,15,0,1122,1135
84301,40,1,16,0,1122,1162
87015,58,5,17,0,1122,1180
88070,41,1,16,0,1122,1163
90948,39,1,16,0,1122,1161
91612,12,1,15,0,1122,1134
91802,77,4,17,0,1122,1199
91996,77,6,17,0,1122,1199
94030,40,1,16,0,1122,1162
97074,73,3,17,0,1122,1195
97197,51,1,16,0,1122,1173
97861,40,1,16,0,1122,1162
97901,40,4,16,0,1122,1162
102427,77,4,17,0,1122,1199
103277,41,1,16,0,1122,1163
103626,75,8,17,0,1122,1197
104376,40,1,16,0,1122,1162
104924,40,1,16,0,1122,1162
105176,40,1,16,0,1122,1162
105627,40,1,16,0,1122,1162
106817,40,1,16,0,1122,1162
107697,40,1,16,0,1122,1162
109623,40,1,16,0,1122,1162
110430,40,1,16,0,1122,1162
112087,40,1,16,0,1122,1162
116444,52,2,16,0,1122,1174
116702,28,1,16,0,1122,1150
116828,75,5,17,0,1122,1197
117031,27,1,16,0,1122,1149
117196,77,4,17,0,1122,1199
118088,40,1,16,0,1122,1162
119854,41,2,16,0,1122,1163
121435,40,1,16,0,1122,1162
123548,40,1,16,0,1122,1162
123634,75,4,17,0,1122,1197
124370,40,1,16,0,1122,1162
125514,75,6,17,0,1122,1197
126567,40,1,16,0,1122,1162
126596,47,1,16,0,1122,1169
128376,47,1,16,0,1122,1169
128422,58,1,17,0,1122,1180
128671,40,1,16,0,1122,1162
128804,40,1,16,0,1122,1162
6789,40,1,16,0,1123,1163
7137,23,1,16,0,1123,1146
7577,46,1,16,0,1123,1169
7787,64,1,17,0,1123,1187
8376,40,1,16,0,1123,1163
8448,7,7,15,0,1123,1130
8909,40,1,16,0,1123,1163
9265,27,2,16,0,1123,1150
10091,40,1,16,0,1123,1163
10525,25,2,16,0,1123,1148
10636,40,1,16,0,1123,1163
12134,55,3,16,0,1123,1178
12196,54,1,16,0,1123,1177
14049,40,1,16,0,1123,1163
14112,40,1,16,0,1123,1163
14227,62,1,17,0,1123,1185
14481,44,1,16,0,1123,1167
14624,40,1,16,0,1123,1163
14871,44,1,16,0,1123,1167
16237,56,4,16,0,1123,1179
17867,49,5,16,0,1123,1172
18035,40,3,16,0,1123,1163
18372,40,1,16,0,1123,1163
18593,23,1,16,0,1123,1146
19308,40,3,16,0,1123,1163
19474,40,2,16,0,1123,1163
21387,40,1,16,0,1123,1163
22214,65,1,17,0,1123,1188
23725,55,1,16,0,1123,1178
24440,40,1,16,0,1123,1163
25159,40,1,16,0,1123,1163
26877,56,3,16,0,1123,1179
27466,40,1,16,0,1123,1163
28058,40,1,16,0,1123,1163
29460,40,1,16,0,1123,1163
29461,40,1,16,0,1123,1163
30517,40,1,16,0,1123,1163
30793,23,2,16,0,1123,1146
31341,40,1,16,0,1123,1163
32111,23,1,16,0,1123,1146
33173,40,1,16,0,1123,1163
34968,40,3,16,0,1123,1163
36154,40,1,16,0,1123,1163
37498,40,2,16,0,1123,1163
38005,40,1,16,0,1123,1163
38347,40,1,16,0,1123,1163
38647,40,1,16,0,1123,1163
38770,40,1,16,0,1123,1163
38993,40,5,16,0,1123,1163
39790,40,1,16,0,1123,1163
40335,62,3,17,0,1123,1185
40777,40,1,16,0,1123,1163
41236,40,1,16,0,1123,1163
41876,40,1,16,0,1123,1163
43066,10,4,15,0,1123,1133
43353,40,2,16,0,1123,1163
43479,40,1,16,0,1123,1163
43774,40,2,16,0,1123,1163
43789,40,1,16,0,1123,1163
44135,40,2,16,0,1123,1163
44381,40,1,16,0,1123,1163
45106,40,1,16,0,1123,1163
45231,40,1,16,0,1123,1163
45448,40,1,16,0,1123,1163
45486,40,1,16,0,1123,1163
46893,25,2,16,0,1123,1148
47266,40,1,16,0,1123,1163
47418,52,1,16,0,1123,1175
48402,40,1,16,0,1123,1163
48532,23,1,16,0,1123,1146
48757,42,1,16,0,1123,1165
49280,23,1,16,0,1123,1146
49307,40,1,16,0,1123,1163
50105,40,1,16,0,1123,1163
50274,40,2,16,0,1123,1163
50317,39,1,16,0,1123,1162
50407,40,1,16,0,1123,1163
50899,40,2,16,0,1123,1163
51439,40,1,16,0,1123,1163
52171,41,1,16,0,1123,1164
52487,40,1,16,0,1123,1163
53153,46,1,16,0,1123,1169
53410,46,3,16,0,1123,1169
53876,40,1,16,0,1123,1163
54102,40,1,16,0,1123,1163
54311,40,1,16,0,1123,1163
57493,40,1,16,0,1123,1163
57517,46,1,16,0,1123,1169
57578,39,1,16,0,1123,1162
58424,40,1,16,0,1123,1163
60229,40,1,16,0,1123,1163
60667,40,1,16,0,1123,1163
61974,40,1,16,0,1123,1163
62315,40,1,16,0,1123,1163
62389,40,1,16,0,1123,1163
63141,40,2,16,0,1123,1163
63228,40,1,16,0,1123,1163
63738,23,1,16,0,1123,1146
63989,40,1,16,0,1123,1163
64939,40,1,16,0,1123,1163
66407,58,5,17,0,1123,1181
66791,40,1,16,0,1123,1163
66823,45,1,16,0,1123,1168
67403,40,1,16,0,1123,1163
67782,44,1,16,0,1123,1167
67819,55,1,16,0,1123,1178
68422,40,2,16,0,1123,1163
69740,40,1,16,0,1123,1163
70004,40,1,16,0,1123,1163
71778,63,1,17,0,1123,1186
72249,40,1,16,0,1123,1163
74750,40,1,16,0,1123,1163
76880,40,3,16,0,1123,1163
77882,45,1,16,0,1123,1168
78128,40,1,16,0,1123,1163
78605,40,1,16,0,1123,1163
78622,25,2,16,0,1123,1148
78816,40,1,16,0,1123,1163
79485,40,1,16,0,1123,1163
79911,40,1,16,0,1123,1163
80292,42,1,16,0,1123,1165
81424,21,8,16,0,1123,1144
82149,40,1,16,0,1123,1163
82443,40,4,16,0,1123,1163
82612,40,2,16,0,1123,1163
84787,7,2,15,0,1123,1130
85827,25,4,16,0,1123,1148
86137,40,1,16,0,1123,1163
86485,40,1,16,0,1123,1163
87136,40,1,16,0,1123,1163
87858,42,3,16,0,1123,1165
88301,40,3,16,0,1123,1163
88711,40,1,16,0,1123,1163
88722,40,1,16,0,1123,1163
89607,40,1,16,0,1123,1163
91809,40,1,16,0,1123,1163
93355,51,1,16,0,1123,1174
94710,40,1,16,0,1123,1163
96534,40,3,16,0,1123,1163
96679,40,1,16,0,1123,1163
96768,40,1,16,0,1123,1163
98866,57,1,17,0,1123,1180
98878,40,1,16,0,1123,1163
102225,23,1,16,0,1123,1146
102512,40,1,16,0,1123,1163
104243,40,1,16,0,1123,1163
105130,40,1,16,0,1123,1163
106544,40,1,16,0,1123,1163
106808,40,1,16,0,1123,1163
107948,56,2,16,0,1123,1179
108110,25,2,16,0,1123,1148
111544,43,2,16,0,1123,1166
111662,40,2,16,0,1123,1163
111927,40,1,16,0,1123,1163
113326,40,1,16,0,1123,1163
113541,40,1,16,0,1123,1163
113951,42,1,16,0,1123,1165
114303,40,1,16,0,1123,1163
115048,40,8,16,0,1123,1163
115147,65,1,17,0,1123,1188
115192,40,1,16,0,1123,1163
115340,40,3,16,0,1123,1163
115358,7,6,15,0,1123,1130
116852,40,1,16,0,1123,1163
117776,46,2,16,0,1123,1169
118242,40,1,16,0,1123,1163
118514,40,1,16,0,1123,1163
118609,40,1,16,0,1123,1163
119143,54,1,16,0,1123,1177
122032,10,1,15,0,1123,1133
122455,40,1,16,0,1123,1163
122772,40,1,16,0,1123,1163
123057,40,1,16,0,1123,1163
123586,39,1,16,0,1123,1162
123823,40,1,16,0,1123,1163
124925,54,1,16,0,1123,1177
125378,40,1,16,0,1123,1163
125479,40,1,16,0,1123,1163
126969,40,1,16,0,1123,1163
127513,40,1,16,0,1123,1163
128245,38,3,16,0,1123,1161
129717,40,1,16,0,1123,1163
5804,39,1,16,0,1124,1163
6573,59,4,17,0,1124,1183
15022,39,2,16,0,1124,1163
17500,47,8,16,0,1124,1171
20879,39,3,16,0,1124,1163
28898,65,3,17,0,1124,1189
30090,46,2,16,1,1124,1170
35021,73,4,17,0,1124,1197
42600,39,1,16,0,1124,1163
58757,39,2,16,0,1124,1163
68156,5,1,15,0,1124,1129
69151,76,3,17,1,1124,1200
77253,5,1,15,0,1124,1129
77397,65,4,17,0,1124,1189
82522,39,3,16,0,1124,1163
85954,51,1,16,0,1124,1175
86308,59,3,17,0,1124,1183
90441,39,2,16,0,1124,1163
95428,53,3,16,0,1124,1177
100988,65,3,17,0,1124,1189
102021,5,1,15,0,1124,1129
107021,6,1,15,0,1124,1130
116513,61,4,17,0,1124,1185
117708,54,1,16,0,1124,1178
120370,67,2,17,0,1124,1191
127233,40,1,16,0,1124,1164
128255,61,4,17,0,1124,1185
16930,66,2,17,1,1125,1191
21306,75,6,17,0,1125,1200
26079,152,1,19,1,1125,1277
38708,38,2,16,0,1125,1163
42206,4,5,15,0,1125,1129
47323,6,3,15,0,1125,1131
50238,38,2,16,0,1125,1163
50456,39,1,16,0,1125,1164
50650,43,9,16,0,1125,1168
55139,47,4,16,0,1125,1172
64184,38,3,16,0,1125,1163
81213,61,2,17,0,1125,1186
89322,38,1,16,0,1125,1163
102877,38,3,16,0,1125,1163
109566,47,2,16,1,1125,1172
127084,38,3,16,0,1125,1163
127544,50,1,16,1,1125,1175
19714,2,1,15,0,1126,1128
31805,64,2,17,0,1126,1190
47439,58,5,17,0,1126,1184
48890,2,1,15,0,1126,1128
61257,2,1,15,0,1126,1128
99144,39,1,16,0,1126,1165
20708,36,2,16,0,1127,1163
24430,36,2,16,0,1127,1163
28838,40,2,16,0,1127,1167
31964,101,1,18,0,1127,1228
48524,54,1,17,0,1127,1181
71220,59,3,17,0,1127,1186
71512,60,3,17,0,1127,1187
78176,38,3,16,0,1127,1165
79630,59,1,17,1,1127,1186
88713,55,1,17,0,1127,1182
92930,20,3,16,0,1127,1147
97610,59,2,17,1,1127,1186
99169,61,2,17,0,1127,1188
120574,61,3,17,0,1127,1188
12113,28,1,16,1,1128,1156
55011,62,4,17,0,1128,1190
67684,18,1,16,0,1128,1146
77696,3,5,15,0,1128,1131
79697,8,3,15,0,1128,1136
17711,18,2,16,0,1129,1147
28764,37,3,16,0,1129,1166
38945,19,1,16,0,1129,1148
42516,50,4,16,0,1129,1179
43837,68,4,17,0,1129,1197
72214,108,4,18,0,1129,1237
11868,33,2,16,0,1130,1163
29524,33,3,16,0,1130,1163
33457,59,6,17,1,1130,1189
38621,138,1,19,1,1130,1268
71403,50,5,17,0,1130,1180
71672,28,1,16,1,1130,1158
111285,52,4,17,0,1130,1182
25821,32,2,16,0,1131,1163
28723,15,3,16,0,1131,1146
75128,65,4,17,0,1131,1196
76029,16,1,16,0,1131,1147
108405,38,2,16,1,1131,1169
112094,16,6,16,1,1131,1147
62033,40,1,16,1,1132,1172
77634,73,3,17,0,1132,1205
107405,11,1,16,0,1132,1143
118255,21,6,16,0,1132,1153
62539,29,2,16,0,1133,1162
74032,71,1,17,1,1133,1204
78175,47,8,17,0,1133,1180
87007,18,1,16,0,1133,1151
110727,11,5,16,0,1133,1144
29020,63,2,17,0,1134,1197
58856,29,2,16,0,1134,1163
67636,66,4,17,1,1134,1200
88029,113,1,18,1,1134,1247
108119,22,4,16,1,1134,1156
11802,48,6,17,0,1135,1183
17890,28,4,16,0,1135,1163
75178,53,3,17,0,1135,1188
29842,50,3,17,0,1136,1186
37010,50,3,17,0,1136,1186
80585,51,2,17,0,1136,1187
89948,55,4,17,1,1136,1191
36080,16,1,16,0,1137,1153
31736,45,2,17,0,1138,1183
78928,45,6,17,0,1138,1183
83050,62,7,17,0,1138,1200
21986,49,3,17,0,1139,1188
27947,8,1,16,1,1139,1147
105511,41,4,17,0,1139,1180
49114,46,1,17,1,1140,1186
114057,23,3,16,0,1140,1163
26117,34,1,16,1,1141,1175
38199,42,4,17,0,1141,1183
127691,60,4,17,0,1141,1201
129589,6,2,16,1,1141,1147
22385,57,5,17,0,1142,1199
57636,41,4,17,0,1142,1183
63393,50,3,17,0,1142,1192
77785,9,5,16,1,1142,1151
121434,63,7,17,0,1142,1205
128062,43,2,17,0,1142,1185
26407,39,7,17,0,1143,1182
40477,45,1,17,0,1143,1188
43066,56,5,17,0,1143,1199
90905,55,6,17,0,1143,1198
16719,24,3,16,0,1144,1168
37382,54,7,17,0,1144,1198
56944,57,2,17,0,1144,1201
78062,44,4,17,0,1144,1188
84787,22,3,16,0,1144,1166
107461,39,7,17,0,1144,1183
107910,32,1,16,1,1144,1176
113065,68,2,17,0,1144,1212
123058,44,4,17,1,1144,1188
123880,25,6,16,0,1144,1169
13518,20,1,16,0,1145,1165
17113,38,2,17,0,1145,1183
17588,70,5,17,0,1145,1215
40779,55,7,17,0,1145,1200
55310,38,2,17,0,1145,1183
59018,38,3,17,0,1145,1183
66014,41,1,17,1,1145,1186
74922,59,7,17,1,1145,1204
83905,22,1,16,0,1145,1167
95762,38,2,17,0,1145,1183
97703,22,4,16,0,1145,1167
97949,23,2,16,0,1145,1168
98879,38,2,17,0,1145,1183
102282,22,7,16,0,1145,1167
124042,30,4,16,1,1145,1175
125035,80,3,18,0,1145,1225
11613,38,2,17,0,1146,1184
12785,37,5,17,0,1146,1183
34460,37,4,17,0,1146,1183
36253,34,4,17,0,1146,1180
48945,45,3,17,0,1146,1191
51847,40,2,17,0,1146,1186
53314,34,3,17,0,1146,1180
63441,79,6,18,0,1146,1225
66277,108,2,18,0,1146,1254
79682,28,3,16,0,1146,1174
85456,45,3,17,0,1146,1191
94304,17,1,16,0,1146,1163
96477,40,6,17,0,1146,1186
97660,20,4,16,0,1146,1166
101672,46,4,17,0,1146,1192
102455,34,2,17,0,1146,1180
105817,37,4,17,0,1146,1183
122032,17,2,16,0,1146,1163
122130,37,4,17,0,1146,1183
124674,40,2,17,0,1146,1186
126008,34,5,17,0,1146,1180
8448,36,8,17,0,1147,1183
9865,19,1,16,0,1147,1166
12185,52,4,17,0,1147,1199
17172,33,4,17,0,1147,1180
24809,18,3,16,0,1147,1165
24957,33,10,17,0,1147,1180
25397,57,5,17,0,1147,1204
36738,18,2,16,0,1147,1165
37842,32,3,16,0,1147,1179
44930,59,3,17,0,1147,1206
47323,16,4,16,0,1147,1163
48601,33,6,17,0,1147,1180
48717,33,6,17,0,1147,1180
49251,50,7,17,0,1147,1197
49303,33,6,17,0,1147,1180
52259,20,3,16,0,1147,1167
53725,19,4,16,0,1147,1166
54193,40,2,17,0,1147,1187
69301,15,5,16,1,1147,1162
72874,33,7,17,0,1147,1180
77696,16,6,16,0,1147,1163
81424,33,9,17,0,1147,1180
88011,52,4,17,0,1147,1199
89197,32,4,16,0,1147,1179
89444,33,6,17,0,1147,1180
95563,33,6,17,0,1147,1180
98049,33,8,17,0,1147,1180
107021,15,2,16,0,1147,1162
108891,35,1,17,0,1147,1182
110218,52,3,17,0,1147,1199
112483,36,7,17,0,1147,1183
113140,16,8,16,0,1147,1163
115358,18,7,16,0,1147,1165
121758,33,7,17,0,1147,1180
6367,39,2,17,0,1148,1187
6605,14,1,16,0,1148,1162
12517,16,5,16,0,1148,1164
16123,15,1,16,0,1148,1163
18026,57,4,17,0,1148,1205
27784,31,3,16,0,1148,1179
30168,63,4,17,1,1148,1211
32186,15,4,16,0,1148,1163
32343,15,3,16,0,1148,1163
33211,14,1,16,0,1148,1162
33712,14,1,16,0,1148,1162
40808,18,3,16,0,1148,1166
41143,18,3,16,0,1148,1166
41603,15,1,16,0,1148,1163
41669,15,2,16,0,1148,1163
42206,57,6,17,0,1148,1205
42972,14,1,16,0,1148,1162
46509,61,5,17,0,1148,1209
52146,15,3,16,0,1148,1163
53238,14,1,16,0,1148,1162
60947,31,4,16,0,1148,1179
62360,51,6,17,0,1148,1199
66415,47,3,17,0,1148,1195
67308,19,3,16,0,1148,1167
70222,15,3,16,0,1148,1163
71102,18,3,16,0,1148,1166
71573,14,1,16,0,1148,1162
82771,31,5,16,0,1148,1179
88628,14,1,16,0,1148,1162
94125,39,2,17,0,1148,1187
104062,31,3,16,0,1148,1179
105710,32,8,17,0,1148,1180
108375,21,3,16,0,1148,1169
111923,15,1,16,0,1148,1163
113123,15,2,16,0,1148,1163
123585,14,1,16,0,1148,1162
127705,15,4,16,0,1148,1163
128252,14,1,16,0,1148,1162
7767,14,1,16,0,1149,1163
7836,37,1,17,0,1149,1186
8821,14,1,16,0,1149,1163
8831,14,1,16,0,1149,1163
9741,39,4,17,0,1149,1188
10025,15,3,16,0,1149,1164
15074,49,3,17,0,1149,1198
15167,14,1,16,0,1149,1163
19114,14,3,16,0,1149,1163
20798,34,3,17,0,1149,1183
21123,30,4,16,0,1149,1179
22076,38,2,17,0,1149,1187
23771,28,4,16,0,1149,1177
23838,34,2,17,0,1149,1183
24563,14,5,16,0,1149,1163
25077,14,1,16,0,1149,1163
25388,47,1,17,0,1149,1196
27684,14,2,16,0,1149,1163
28099,14,1,16,0,1149,1163
28500,14,1,16,0,1149,1163
28933,15,2,16,0,1149,1164
29870,14,2,16,0,1149,1163
35360,31,5,17,0,1149,1180
37005,40,3,17,0,1149,1189
37009,14,1,16,0,1149,1163
38608,15,2,16,0,1149,1164
40578,68,4,17,1,1149,1217
42609,14,1,16,0,1149,1163
44985,50,4,17,0,1149,1199
45168,28,4,16,0,1149,1177
47353,30,3,16,1,1149,1179
50203,34,1,17,0,1149,1183
51686,14,1,16,0,1149,1163
52293,14,2,16,0,1149,1163
52762,14,2,16,0,1149,1163
53485,46,3,17,0,1149,1195
57926,14,2,16,0,1149,1163
59319,16,5,16,0,1149,1165
59849,14,2,16,0,1149,1163
61078,58,3,17,1,1149,1207
61238,14,1,16,0,1149,1163
62001,32,1,17,0,1149,1181
64513,14,2,16,0,1149,1163
67262,14,1,16,0,1149,1163
69450,15,2,16,0,1149,1164
77395,16,3,16,0,1149,1165
77476,14,1,16,0,1149,1163
79886,14,11,16,0,1149,1163
85909,22,2,16,0,1149,1171
90071,56,3,17,0,1149,1205
93201,34,2,17,0,1149,1183
93346,31,2,17,0,1149,1180
97444,51,3,17,0,1149,1200
101525,34,2,17,0,1149,1183
102997,14,7,16,0,1149,1163
103045,14,2,16,0,1149,1163
103503,14,1,16,0,1149,1163
106589,50,4,17,0,1149,1199
106663,24,5,16,0,1149,1173
107624,32,2,17,0,1149,1181
109648,30,1,16,0,1149,1179
109762,14,6,16,0,1149,1163
117654,23,1,16,0,1149,1172
119007,49,3,17,0,1149,1198
119092,14,1,16,0,1149,1163
120150,14,2,16,0,1149,1163
122916,15,5,16,0,1149,1164
123264,14,3,16,0,1149,1163
124767,32,1,17,0,1149,1181
125713,8,1,16,0,1149,1157
126774,49,3,17,0,1149,1198
129732,34,2,17,0,1149,1183
12622,12,3,16,0,1150,1162
31317,31,1,17,0,1150,1181
10001,12,1,16,0,1151,1163
88327,12,1,16,0,1151,1163
25797,47,1,17,0,1152,1199
96059,10,2,16,0,1152,1162
116162,29,1,17,1,1152,1181
8353,8,2,16,0,1153,1161
24119,6,3,16,0,1153,1159
35366,42,2,17,1,1153,1195
24549,12,1,16,0,1154,1166
47730,12,2,16,0,1154,1166
77137,12,1,16,0,1154,1166
99027,12,1,16,0,1154,1166
81519,39,1,17,0,1155,1194
115113,41,5,17,1,1155,1196
13306,8,5,16,0,1156,1164
17521,8,5,16,0,1156,1164
17616,8,4,16,0,1156,1164
26838,8,2,16,0,1156,1164
33346,8,1,16,0,1156,1164
46285,25,1,17,1,1156,1181
48049,8,2,16,0,1156,1164
48607,8,1,16,0,1156,1164
53224,8,2,16,0,1156,1164
55146,8,4,16,0,1156,1164
61698,32,1,17,1,1156,1188
72270,8,4,16,0,1156,1164
80610,8,3,16,0,1156,1164
82167,31,6,17,1,1156,1187
92716,8,1,16,0,1156,1164
94918,8,1,16,0,1156,1164
96348,8,3,16,0,1156,1164
99369,8,1,16,0,1156,1164
110612,8,1,16,0,1156,1164
111690,24,2,17,0,1156,1180
122583,25,1,17,1,1156,1181
129465,8,2,16,0,1156,1164
8492,4,6,16,0,1157,1161
88912,20,1,16,1,1158,1178
78262,23,2,17,1,1159,1182
84163,21,3,17,0,1159,1180
99463,23,1,17,0,1159,1182
108894,23,1,17,0,1159,1182
109687,29,3,17,1,1159,1188
28203,24,2,17,0,1160,1184
60838,24,3,17,0,1160,1184
64375,24,2,17,0,1160,1184
68488,24,2,17,0,1160,1184
69392,24,3,17,0,1160,1184
84298,24,2,17,0,1160,1184
91932,21,1,17,0,1160,1181
104735,21,1,17,0,1160,1181
107405,27,2,17,0,1160,1187
20115,19,2,17,0,1161,1180
28777,19,1,17,0,1161,1180
29599,11,1,16,0,1161,1172
32052,19,1,17,0,1161,1180
32812,19,1,17,0,1161,1180
38094,39,1,17,0,1161,1200
44546,19,1,17,0,1161,1180
54601,19,1,17,0,1161,1180
67004,19,4,17,0,1161,1180
69150,47,2,17,0,1161,1208
76575,19,1,17,0,1161,1180
78774,23,3,17,0,1161,1184
78866,19,1,17,0,1161,1180
82093,19,1,17,0,1161,1180
83975,19,1,17,0,1161,1180
87007,54,2,17,0,1161,1215
105801,19,2,17,0,1161,1180
106528,19,2,17,0,1161,1180
107152,23,2,17,0,1161,1184
110670,19,1,17,0,1161,1180
111978,19,1,17,0,1161,1180
116729,82,3,18,0,1161,1243
116840,19,1,17,0,1161,1180
117982,19,1,17,0,1161,1180
119004,88,4,18,0,1161,1249
121777,19,1,17,0,1161,1180
128355,19,2,17,0,1161,1180
20074,53,1,17,0,1162,1215
33275,25,3,17,0,1162,1187
37644,22,3,17,0,1162,1184
64847,18,4,17,0,1162,1180
104232,20,3,17,1,1162,1182
17711,9,3,16,0,1163,1172
38945,87,2,18,0,1163,1250
53117,14,2,16,1,1163,1177
53513,21,2,17,0,1163,1184
6281,13,1,16,0,1164,1177
6844,13,1,16,0,1164,1177
8980,13,1,16,0,1164,1177
10438,13,1,16,0,1164,1177
10834,16,2,17,0,1164,1180
11528,13,1,16,0,1164,1177
12910,13,1,16,0,1164,1177
13106,13,1,16,0,1164,1177
17703,13,2,16,0,1164,1177
18640,17,1,17,0,1164,1181
19704,13,1,16,0,1164,1177
19841,13,1,16,0,1164,1177
21107,13,1,16,0,1164,1177
23018,16,6,17,0,1164,1180
24302,13,1,16,0,1164,1177
24622,13,1,16,0,1164,1177
27736,16,3,17,0,1164,1180
29806,13,1,16,0,1164,1177
30475,13,1,16,0,1164,1177
32060,13,1,16,0,1164,1177
33009,88,1,18,1,1164,1252
34014,16,2,17,0,1164,1180
35442,13,1,16,0,1164,1177
37074,13,1,16,0,1164,1177
38048,13,1,16,0,1164,1177
38486,13,1,16,0,1164,1177
39409,13,1,16,0,1164,1177
40113,16,7,17,0,1164,1180
40204,13,1,16,0,1164,1177
40887,13,1,16,0,1164,1177
41069,13,1,16,0,1164,1177
41121,16,3,17,0,1164,1180
41329,13,1,16,0,1164,1177
44006,16,2,17,0,1164,1180
45061,13,1,16,0,1164,1177
47699,13,1,16,0,1164,1177
50324,13,2,16,0,1164,1177
51381,13,1,16,0,1164,1177
52830,13,1,16,0,1164,1177
53093,13,1,16,0,1164,1177
53263,13,2,16,0,1164,1177
53342,12,1,16,0,1164,1176
55800,13,1,16,0,1164,1177
56143,16,7,17,0,1164,1180
56295,13,3,16,0,1164,1177
58096,13,1,16,0,1164,1177
58250,13,1,16,0,1164,1177
59207,13,1,16,0,1164,1177
59485,13,1,16,0,1164,1177
60506,67,2,18,0,1164,1231
61596,13,3,16,0,1164,1177
63216,13,1,16,0,1164,1177
65654,13,1,16,0,1164,1177
67287,13,1,16,0,1164,1177
67317,13,1,16,0,1164,1177
68268,45,5,17,0,1164,1209
68975,13,1,16,0,1164,1177
71840,16,6,17,0,1164,1180
72994,13,2,16,0,1164,1177
73498,13,1,16,0,1164,1177
74007,13,1,16,0,1164,1177
74971,13,1,16,0,1164,1177
75825,16,2,17,0,1164,1180
76624,43,5,17,1,1164,1207
78122,13,1,16,0,1164,1177
79276,13,1,16,0,1164,1177
79697,24,4,17,0,1164,1188
79933,13,1,16,0,1164,1177
81892,82,1,18,0,1164,1246
82811,13,1,16,0,1164,1177
83797,16,2,17,0,1164,1180
85473,16,2,17,0,1164,1180
85882,13,2,16,0,1164,1177
87405,42,1,17,0,1164,1206
88085,13,1,16,0,1164,1177
89966,13,3,16,0,1164,1177
90997,13,1,16,0,1164,1177
91207,13,1,16,0,1164,1177
92815,13,1,16,0,1164,1177
93030,13,1,16,0,1164,1177
94299,13,1,16,0,1164,1177
94628,13,1,16,0,1164,1177
95651,13,1,16,0,1164,1177
98787,13,1,16,0,1164,1177
100550,16,4,17,0,1164,1180
102807,13,2,16,0,1164,1177
103868,13,1,16,0,1164,1177
104959,13,1,16,0,1164,1177
106083,13,1,16,0,1164,1177
111235,13,1,16,0,1164,1177
113027,13,1,16,0,1164,1177
113358,13,1,16,0,1164,1177
115044,13,1,16,0,1164,1177
115172,13,2,16,0,1164,1177
115731,13,1,16,0,1164,1177
115842,13,2,16,0,1164,1177
117753,13,1,16,0,1164,1177
119077,13,1,16,0,1164,1177
119819,13,1,16,0,1164,1177
123063,13,1,16,0,1164,1177
123514,13,1,16,0,1164,1177
123988,13,1,16,0,1164,1177
124370,13,2,16,0,1164,1177
125797,13,1,16,0,1164,1177
126101,16,2,17,0,1164,1180
126882,13,1,16,0,1164,1177
126884,13,1,16,0,1164,1177
127334,13,1,16,0,1164,1177
128945,13,1,16,0,1164,1177
129544,13,2,16,0,1164,1177
15069,47,2,17,0,1165,1212
15206,36,2,17,0,1165,1201
23630,18,2,17,0,1165,1183
29243,47,1,17,0,1165,1212
34810,14,6,16,0,1165,1179
37215,36,4,17,0,1165,1201
37223,19,3,17,0,1165,1184
37976,60,3,18,0,1165,1225
41830,14,4,16,0,1165,1179
43034,23,1,17,0,1165,1188
45330,17,3,17,0,1165,1182
46552,47,1,17,0,1165,1212
54311,71,2,18,0,1165,1236
55740,47,1,17,0,1165,1212
59920,47,1,17,0,1165,1212
76880,15,4,17,0,1165,1180
86137,10,2,16,0,1165,1175
91988,47,1,17,0,1165,1212
103547,34,8,17,0,1165,1199
104419,14,5,16,0,1165,1179
108181,10,1,16,0,1165,1175
109163,10,1,16,0,1165,1175
114994,47,2,17,0,1165,1212
117095,47,1,17,0,1165,1212
121457,47,1,17,0,1165,1212
126934,47,1,17,0,1165,1212
129534,36,4,17,0,1165,1201
8335,9,3,16,0,1166,1175
47318,21,1,17,0,1166,1187
48137,17,1,17,0,1166,1183
78620,9,1,16,0,1166,1175
85406,14,1,17,1,1166,1180
93573,58,2,17,0,1166,1224
116062,26,1,17,0,1166,1192
118084,9,1,16,0,1166,1175
122336,48,5,17,0,1166,1214
123816,49,2,17,0,1166,1215
129655,10,1,16,0,1166,1176
8489,111,2,19,0,1167,1278
29991,111,2,19,0,1167,1278
48287,20,2,17,0,1167,1187
61989,44,3,17,0,1167,1211
86145,10,1,16,0,1167,1177
94030,90,2,18,0,1167,1257
104871,10,2,16,0,1167,1177
106976,59,1,18,0,1167,1226
112570,10,1,16,0,1167,1177
125834,10,1,16,0,1167,1177
17521,15,6,17,0,1168,1183
44773,66,1,18,0,1168,1234
47549,110,2,19,0,1168,1278
52035,60,1,18,0,1168,1228
81344,19,7,17,0,1168,1187
90914,10,2,16,0,1168,1178
105504,10,2,16,0,1168,1178
105699,12,5,17,0,1168,1180
113211,8,1,16,0,1168,1176
118866,34,4,17,0,1168,1202
10739,15,4,17,0,1169,1184
26577,17,4,17,0,1169,1186
84956,88,1,18,0,1169,1257
10512,30,1,17,0,1170,1200
29160,13,2,17,0,1170,1183
36643,31,2,17,0,1170,1201
44619,64,1,18,0,1170,1234
61326,14,1,17,0,1170,1184
67661,25,3,17,1,1170,1195
75071,5,3,16,0,1170,1175
114366,42,2,17,0,1170,1212
125713,7,2,16,0,1170,1177
48757,17,2,17,0,1171,1188
52171,17,2,17,0,1171,1188
58320,13,5,17,1,1171,1184
99049,10,6,17,0,1171,1181
107036,28,1,17,0,1171,1199
107038,62,1,18,0,1171,1233
113951,17,2,17,0,1171,1188
128060,55,1,18,0,1171,1226
18512,9,1,17,0,1172,1181
46659,54,1,18,0,1172,1226
46948,9,1,17,0,1172,1181
66848,9,1,17,0,1172,1181
106004,9,1,17,0,1172,1181
107780,9,1,17,0,1172,1181
115358,6,8,16,0,1172,1178
17399,15,1,17,0,1173,1188
17591,55,2,18,0,1173,1228
42802,76,2,18,0,1173,1249
59614,16,1,17,0,1173,1189
60368,102,1,19,0,1173,1275
78176,13,4,17,0,1173,1186
87346,7,4,17,0,1173,1180
102282,5,8,16,0,1173,1178
105877,8,1,17,0,1173,1181
106544,8,2,17,0,1173,1181
125021,6,1,16,0,1173,1179
127233,5,2,16,0,1173,1178
5948,3,5,16,0,1174,1177
14705,5,1,16,0,1174,1179
40937,3,7,16,0,1174,1177
84382,6,3,17,0,1174,1180
116702,10,2,17,0,1174,1184
117413,52,3,18,0,1174,1226
16719,23,4,17,0,1175,1198
20170,12,1,17,0,1175,1187
55701,17,1,17,0,1175,1192
70755,50,2,18,0,1175,1225
84161,25,3,17,0,1175,1200
85300,5,2,17,0,1175,1180
120312,12,2,17,0,1175,1187
11652,49,1,18,0,1176,1225
48040,9,2,17,0,1176,1185
67187,25,4,17,1,1176,1201
78605,51,2,18,0,1176,1227
78622,6,3,17,0,1176,1182
102458,102,2,19,0,1176,1278
109566,83,3,18,1,1176,1259
7709,66,1,18,0,1177,1243
28932,11,3,17,0,1177,1188
54334,13,1,17,0,1177,1190
60510,53,1,18,0,1177,1230
78816,10,2,17,0,1177,1187
88685,14,3,17,0,1177,1191
94134,3,2,17,0,1177,1180
105475,13,1,17,0,1177,1190
113803,23,3,17,0,1177,1200
8376,5,2,17,0,1178,1183
15930,5,2,17,0,1178,1183
17739,5,2,17,0,1178,1183
28723,4,4,17,0,1178,1182
69986,78,2,18,0,1178,1256
110788,5,2,17,0,1178,1183
121681,10,3,17,0,1178,1188
127944,43,1,17,0,1178,1221
7557,45,4,17,1,1179,1224
10655,17,3,17,0,1179,1196
17150,9,1,17,0,1179,1188
30090,82,3,19,1,1179,1261
51877,9,2,17,0,1179,1188
124644,21,2,17,0,1179,1200
17053,9,3,17,0,1180,1189
26702,27,3,17,0,1180,1207
66889,74,1,18,0,1180,1254
77749,25,3,17,0,1180,1205
112029,74,1,18,0,1180,1254
113211,55,2,18,0,1180,1235
6295,74,2,18,0,1181,1255
9265,24,3,17,0,1181,1205
14552,6,2,17,0,1181,1187
16744,42,4,17,1,1181,1223
19714,74,2,18,0,1181,1255
20638,74,2,18,0,1181,1255
26204,96,1,19,0,1181,1277
46553,97,2,19,0,1181,1278
48890,74,2,18,0,1181,1255
61257,74,2,18,0,1181,1255
67106,74,2,18,0,1181,1255
69450,5,3,17,0,1181,1186
73904,74,2,18,0,1181,1255
74697,18,5,17,0,1181,1199
107486,74,1,18,0,1181,1255
117654,2,2,17,0,1181,1183
128289,4,4,17,0,1181,1185
23018,23,7,17,0,1182,1205
26559,6,2,17,0,1182,1188
39564,23,5,17,0,1182,1205
47193,7,1,17,0,1182,1189
55689,29,4,17,0,1182,1211
59119,43,1,18,0,1182,1225
69867,23,3,17,0,1182,1205
87823,47,1,18,0,1182,1229
101142,8,2,17,0,1182,1190
14026,62,1,18,0,1183,1245
14402,45,1,18,0,1183,1228
15560,45,2,18,0,1183,1228
18372,45,2,18,0,1183,1228
21543,68,1,18,0,1183,1251
21817,45,1,18,0,1183,1228
23725,14,2,17,0,1183,1197
31140,45,1,18,0,1183,1228
35670,68,1,18,0,1183,1251
35926,45,2,18,0,1183,1228
40886,68,1,18,0,1183,1251
45318,68,1,18,0,1183,1251
50344,68,1,18,0,1183,1251
61095,68,2,18,0,1183,1251
67819,14,2,17,0,1183,1197
69854,62,1,18,0,1183,1245
73910,45,1,18,0,1183,1228
77253,69,2,18,0,1183,1252
80495,45,1,18,0,1183,1228
84469,45,2,18,0,1183,1228
92920,45,1,18,0,1183,1228
94312,68,1,18,0,1183,1251
96507,45,1,18,0,1183,1228
97947,45,1,18,0,1183,1228
98112,45,1,18,0,1183,1228
105892,69,1,18,0,1183,1252
113140,58,9,18,0,1183,1241
113919,68,1,18,0,1183,1251
120133,45,1,18,0,1183,1228
121702,3,1,17,0,1183,1186
122293,45,1,18,0,1183,1228
123880,22,7,17,0,1183,1205
125600,45,3,18,0,1183,1228
129146,45,1,18,0,1183,1228
129731,45,1,18,0,1183,1228
5724,27,3,17,0,1184,1211
8573,16,1,17,0,1184,1200
9601,68,1,18,0,1184,1252
11978,11,1,17,0,1184,1195
13692,16,1,17,0,1184,1200
25190,68,1,18,0,1184,1252
25460,16,1,17,0,1184,1200
31802,68,1,18,0,1184,1252
33604,68,1,18,0,1184,1252
34264,16,1,17,0,1184,1200
52219,68,1,18,0,1184,1252
59742,68,1,18,0,1184,1252
63063,49,2,18,0,1184,1233
63288,68,1,18,0,1184,1252
64513,16,3,17,0,1184,1200
68156,68,2,18,0,1184,1252
68887,68,1,18,0,1184,1252
71122,17,1,17,0,1184,1201
73670,68,2,18,0,1184,1252
75053,70,2,18,0,1184,1254
77015,57,2,18,0,1184,1241
79488,68,1,18,0,1184,1252
81424,68,10,18,0,1184,1252
83758,16,1,17,0,1184,1200
91612,68,2,18,0,1184,1252
92870,70,1,18,0,1184,1254
97660,17,5,17,0,1184,1201
99514,68,2,18,0,1184,1252
99960,68,1,18,0,1184,1252
101276,16,1,17,0,1184,1200
102021,68,2,18,0,1184,1252
102633,68,1,18,0,1184,1252
102703,16,4,17,0,1184,1200
105072,16,1,17,0,1184,1200
105630,17,1,17,0,1184,1201
119581,16,1,17,0,1184,1200
122087,47,2,18,0,1184,1231
123586,68,2,18,0,1184,1252
124925,12,2,17,0,1184,1196
129441,68,1,18,0,1184,1252
43774,20,3,17,0,1185,1205
54659,29,7,17,0,1185,1214
73513,55,4,18,0,1185,1240
82771,9,6,17,0,1185,1194
90914,29,3,17,0,1185,1214
8091,39,1,18,1,1186,1225
10424,39,2,18,0,1186,1225
11274,39,1,18,0,1186,1225
11610,39,1,18,0,1186,1225
11750,39,2,18,0,1186,1225
13261,39,1,18,0,1186,1225
13391,48,6,18,0,1186,1234
16056,10,2,17,0,1186,1196
16944,39,1,18,0,1186,1225
17319,39,1,18,0,1186,1225
18120,39,1,18,0,1186,1225
18779,39,1,18,0,1186,1225
28693,39,1,18,0,1186,1225
28843,39,1,18,0,1186,1225
32801,39,1,18,0,1186,1225
32963,39,3,18,0,1186,1225
34483,39,1,18,0,1186,1225
35688,39,1,18,0,1186,1225
35824,39,1,18,0,1186,1225
36821,39,1,18,0,1186,1225
38401,39,1,18,0,1186,1225
39050,39,1,18,0,1186,1225
39683,39,2,18,0,1186,1225
40580,39,1,18,0,1186,1225
41241,14,5,17,0,1186,1200
43607,39,1,18,0,1186,1225
49127,39,1,18,0,1186,1225
50967,39,1,18,0,1186,1225
54883,39,1,18,0,1186,1225
56295,39,4,18,0,1186,1225
58888,39,1,18,0,1186,1225
59190,39,1,18,0,1186,1225
59340,39,1,18,0,1186,1225
62294,39,1,18,0,1186,1225
64533,39,1,18,0,1186,1225
70786,39,2,18,0,1186,1225
70853,39,1,18,0,1186,1225
73327,39,1,18,0,1186,1225
79297,39,1,18,0,1186,1225
79871,39,1,18,0,1186,1225
81919,92,1,19,0,1186,1278
82263,39,3,18,0,1186,1225
82512,39,2,18,0,1186,1225
83233,39,1,18,0,1186,1225
85071,39,1,18,0,1186,1225
86496,39,1,18,0,1186,1225
90265,39,1,18,0,1186,1225
92572,39,1,18,0,1186,1225
92916,39,1,18,0,1186,1225
93355,39,2,18,0,1186,1225
94840,70,1,18,0,1186,1256
95600,39,1,18,0,1186,1225
102866,39,1,18,0,1186,1225
105291,39,1,18,0,1186,1225
107646,39,1,18,0,1186,1225
107814,39,1,18,0,1186,1225
108718,39,1,18,0,1186,1225
110833,39,1,18,0,1186,1225
116121,39,1,18,0,1186,1225
120184,39,1,18,0,1186,1225
120738,39,1,18,0,1186,1225
120809,39,2,18,0,1186,1225
120839,39,1,18,0,1186,1225
129314,39,1,18,0,1186,1225
18209,58,5,18,0,1187,1245
81057,35,1,17,0,1187,1222
96203,35,1,17,0,1187,1222
106632,9,4,17,0,1187,1196
117407,35,1,17,0,1187,1222
9498,53,2,18,0,1188,1241
71058,13,1,17,0,1188,1201
89197,5,5,17,0,1188,1193
125713,12,3,17,0,1188,1200
17804,11,1,17,0,1189,1200
44121,45,6,18,0,1189,1234
96684,12,4,17,0,1189,1201
127036,11,1,17,0,1189,1200
26217,78,1,19,0,1191,1269
85484,78,1,19,0,1191,1269
8013,15,2,17,0,1192,1207
95126,24,1,17,0,1192,1216
123112,61,1,18,0,1193,1254
125611,12,7,17,0,1193,1205
20893,15,3,17,0,1194,1209
102867,72,2,19,0,1194,1266
17388,39,5,18,0,1195,1234
38259,39,1,18,0,1195,1234
50486,39,1,18,0,1195,1234
57708,39,1,18,0,1195,1234
69818,39,1,18,0,1195,1234
72293,39,2,18,0,1195,1234
76029,39,2,18,0,1195,1234
78816,32,3,18,0,1195,1227
83031,39,1,18,0,1195,1234
88274,39,1,18,0,1195,1234
89124,63,5,18,1,1195,1258
91747,39,1,18,0,1195,1234
114797,39,1,18,0,1195,1234
115432,13,2,17,0,1195,1208
49658,30,1,18,0,1196,1226
52171,29,3,18,0,1196,1225
54937,17,2,17,0,1196,1213
56405,77,1,19,0,1196,1273
63214,46,1,18,0,1196,1242
106997,77,1,19,0,1196,1273
122745,55,1,18,0,1196,1251
5656,11,4,17,0,1197,1208
12379,18,5,17,0,1197,1215
14049,21,2,17,0,1197,1218
69740,52,2,18,0,1197,1249
85116,11,2,17,0,1197,1208
90198,36,2,18,0,1197,1233
91738,4,3,17,0,1197,1201
101400,27,3,17,0,1197,1224
113688,19,3,17,0,1197,1216
21913,35,3,18,1,1198,1233
25002,76,1,19,0,1198,1274
33248,10,3,17,0,1198,1208
47323,23,5,17,0,1198,1221
49114,51,2,18,1,1198,1249
50119,76,1,19,0,1198,1274
54365,7,2,17,0,1198,1205
75442,7,4,17,0,1198,1205
92065,17,2,17,1,1198,1215
104232,71,4,19,1,1198,1269
105504,9,3,17,0,1198,1207
109336,69,1,19,1,1198,1267
115113,18,6,17,1,1198,1216
28764,41,4,18,0,1199,1240
43330,7,3,17,0,1199,1206
90375,26,2,18,0,1199,1225
101611,67,1,19,1,1199,1266
122032,63,3,19,0,1199,1262
12134,43,4,18,0,1200,1243
21752,30,1,18,0,1200,1230
53204,63,1,19,0,1200,1263
70222,16,4,17,0,1200,1216
75072,3,6,17,0,1200,1203
79886,15,12,17,0,1200,1215
83905,17,2,17,0,1200,1217
97703,17,5,17,0,1200,1217
116162,40,2,18,1,1200,1240
123119,12,3,17,0,1200,1212
15644,55,3,18,1,1201,1256
19099,10,3,17,0,1201,1211
69977,16,4,17,0,1201,1217
26117,12,2,17,1,1202,1214
27420,27,1,18,0,1202,1229
28594,14,1,17,0,1202,1216
46957,66,1,19,0,1202,1268
88713,39,2,18,0,1202,1241
116062,51,2,18,0,1202,1253
32343,10,4,17,0,1203,1213
33744,9,1,17,0,1203,1212
52762,9,3,17,0,1203,1212
107280,75,1,19,0,1203,1278
17804,48,2,18,0,1204,1252
19114,8,4,17,0,1204,1212
33275,7,4,17,0,1204,1211
49335,40,2,18,0,1204,1244
71058,71,2,19,0,1204,1275
71122,48,2,18,0,1204,1252
72706,24,1,18,1,1204,1228
96684,47,5,18,0,1204,1251
104544,41,2,18,0,1204,1245
109687,24,4,18,1,1204,1228
125713,43,4,18,0,1204,1247
6612,23,2,18,0,1205,1228
8335,8,4,17,1,1205,1213
10636,39,2,18,0,1205,1244
15206,6,3,17,0,1205,1211
17402,39,3,18,0,1205,1244
18221,20,2,18,0,1205,1225
37215,5,5,17,0,1205,1210
44613,49,1,18,0,1205,1254
49307,39,2,18,0,1205,1244
55011,14,5,17,0,1205,1219
66561,7,2,17,0,1205,1212
75072,33,7,18,0,1205,1238
83568,54,1,18,1,1205,1259
90604,42,1,18,0,1205,1247
98902,49,1,18,1,1205,1254
106857,33,2,18,0,1205,1238
107659,42,1,18,0,1205,1247
114770,49,1,18,1,1205,1254
124193,20,3,18,0,1205,1225
129534,5,5,17,0,1205,1210
7767,6,2,17,0,1206,1212
8821,6,2,17,0,1206,1212
8831,6,2,17,0,1206,1212
12196,36,2,18,0,1206,1242
14559,69,1,19,0,1206,1275
15167,6,2,17,0,1206,1212
21150,50,1,18,1,1206,1256
23725,40,3,18,0,1206,1246
25077,6,2,17,0,1206,1212
27684,6,3,17,0,1206,1212
28099,6,2,17,0,1206,1212
28500,6,2,17,0,1206,1212
32186,7,5,17,0,1206,1213
33011,3,5,17,0,1206,1209
33643,19,1,18,0,1206,1225
36643,3,3,17,0,1206,1209
37009,6,2,17,0,1206,1212
40335,6,4,17,0,1206,1212
43949,7,6,17,0,1206,1213
51686,6,2,17,0,1206,1212
52293,6,3,17,0,1206,1212
53050,12,5,17,1,1206,1218
57926,6,3,17,0,1206,1212
61238,6,2,17,0,1206,1212
62255,32,1,18,0,1206,1238
64513,7,4,17,0,1206,1213
67262,6,2,17,0,1206,1212
67819,40,3,18,0,1206,1246
77476,6,2,17,0,1206,1212
99770,23,1,18,0,1206,1229
103045,6,3,17,0,1206,1212
103503,6,2,17,0,1206,1212
112094,23,7,18,0,1206,1229
114723,23,1,18,0,1206,1229
119092,6,2,17,0,1206,1212
120150,6,3,17,0,1206,1212
122682,21,1,18,0,1206,1227
123264,6,4,17,0,1206,1212
124925,40,3,18,0,1206,1246
127036,46,2,18,0,1206,1252
127705,6,5,17,0,1206,1212
11165,56,1,19,0,1207,1263
40808,4,4,17,0,1207,1211
41143,4,4,17,0,1207,1211
47193,39,2,18,0,1207,1246
52415,58,2,19,0,1207,1265
71102,4,4,17,0,1207,1211
71762,68,1,19,0,1207,1275
77030,40,2,18,0,1207,1247
80691,31,4,18,0,1207,1238
88722,42,2,18,0,1207,1249
102181,9,1,17,0,1207,1216
104825,45,2,18,0,1207,1252
107624,21,3,18,0,1207,1228
112455,45,2,18,0,1207,1252
126819,49,1,18,0,1207,1256
129309,2,2,17,0,1207,1209
124042,5,5,17,1,1208,1213
11536,66,1,19,0,1209,1275
17399,37,2,18,0,1209,1246
24338,49,1,18,0,1209,1258
25390,65,1,19,0,1209,1274
26749,40,2,18,0,1209,1249
35603,36,1,18,0,1209,1245
58858,40,1,18,0,1209,1249
66014,41,2,18,1,1209,1250
85954,31,2,18,0,1209,1240
90335,42,2,18,0,1209,1251
106544,40,3,18,0,1209,1249
120370,56,3,19,0,1209,1265
129886,13,1,17,0,1209,1222
10091,36,2,18,0,1210,1246
19308,36,4,18,0,1210,1246
21306,17,7,18,0,1210,1227
26563,4,4,17,0,1210,1214
28203,4,3,17,0,1210,1214
35982,6,2,17,0,1210,1216
43789,39,2,18,0,1210,1249
47418,30,2,18,0,1210,1240
64375,4,3,17,0,1210,1214
66415,30,4,18,0,1210,1240
67403,51,2,19,0,1210,1261
68488,4,3,17,0,1210,1214
69392,4,4,17,0,1210,1214
80292,30,2,18,0,1210,1240
83002,14,2,17,0,1210,1224
84298,4,3,17,0,1210,1214
86717,15,1,18,0,1210,1225
96544,15,5,18,0,1210,1225
98878,36,2,18,0,1210,1246
99144,36,2,18,0,1210,1246
100496,34,2,18,0,1210,1244
104419,28,6,18,0,1210,1238
107021,32,3,18,0,1210,1242
111927,32,2,18,0,1210,1242
116925,52,3,19,0,1210,1262
127233,26,3,18,0,1210,1236
23459,35,2,18,0,1211,1246
31055,39,1,18,0,1211,1250
39306,40,2,18,0,1211,1251
58288,14,1,18,0,1211,1225
65711,44,6,18,0,1211,1255
87858,29,4,18,0,1211,1240
110218,35,4,18,0,1211,1246
45330,2,4,17,0,1212,1214
55608,53,2,19,0,1212,1265
72813,37,4,18,0,1212,1249
88011,14,5,18,0,1212,1226
97272,35,1,18,0,1212,1247
101069,26,1,18,0,1212,1238
115340,2,4,17,0,1212,1214
118242,30,2,18,0,1212,1242
7577,31,2,18,0,1213,1244
14481,31,2,18,0,1213,1244
34810,13,7,18,0,1213,1226
43774,39,4,18,0,1213,1252
53153,33,2,18,0,1213,1246
53410,31,4,18,0,1213,1244
57517,31,2,18,0,1213,1244
60108,33,2,18,0,1213,1246
62264,28,2,18,0,1213,1241
97197,31,2,18,0,1213,1244
98866,26,2,18,0,1213,1239
105732,39,1,18,0,1213,1252
113541,29,2,18,0,1213,1242
117708,28,2,18,0,1213,1241
118609,29,2,18,0,1213,1242
128376,29,2,18,0,1213,1242
11978,11,2,18,0,1214,1225
15074,11,4,18,0,1214,1225
74809,39,3,18,1,1214,1253
96416,45,2,18,1,1214,1259
119007,11,4,18,0,1214,1225
68102,39,1,18,0,1215,1254
66494,16,1,18,0,1219,1235
9399,14,1,18,0,1220,1234
20309,14,1,18,0,1220,1234
53050,40,6,19,1,1220,1260
93999,14,1,18,0,1220,1234
112667,14,1,18,0,1220,1234
12113,34,2,18,1,1221,1255
105178,33,1,18,1,1221,1254
8013,34,3,18,0,1222,1256
55902,10,1,18,0,1222,1232
74125,10,2,18,0,1222,1232
121643,10,1,18,0,1222,1232
122336,10,6,18,0,1222,1232
126350,10,2,18,0,1222,1232
127544,10,2,18,0,1222,1232
9265,11,4,18,0,1223,1234
99449,23,1,18,0,1223,1246
89878,27,1,18,1,1224,1251
92930,11,4,18,0,1224,1235
40311,40,4,19,1,1225,1265
104488,4,1,18,0,1225,1229
57809,23,5,18,1,1226,1249
61073,35,3,19,1,1226,1261
66561,9,3,18,0,1226,1235
127031,15,2,18,0,1226,1241
9344,21,1,18,1,1227,1248
50894,14,1,18,0,1227,1241
121790,40,3,19,0,1227,1267
20453,46,1,19,0,1228,1274
30497,13,2,18,0,1228,1241
67187,36,5,19,1,1228,1264
120956,29,4,18,1,1228,1257
40079,17,2,18,1,1229,1246
52029,15,2,18,0,1229,1244
78512,14,3,18,0,1229,1243
32266,4,1,18,0,1230,1234
71672,15,2,18,1,1230,1245
45617,11,1,18,0,1231,1242
72816,11,1,18,0,1231,1242
75071,24,4,18,0,1231,1255
93752,40,1,19,0,1231,1271
94611,11,1,18,0,1231,1242
95741,11,1,18,0,1231,1242
58221,15,2,18,1,1232,1247
79227,11,2,18,1,1232,1243
115113,9,7,18,1,1232,1241
63393,11,4,18,0,1234,1245
92065,33,3,19,1,1234,1267
127420,11,1,18,0,1234,1245
99770,40,2,19,0,1235,1275
122682,8,2,18,0,1235,1243
21306,3,8,18,0,1236,1239
88011,3,6,18,0,1236,1239
44773,39,2,19,0,1239,1278
60506,33,3,19,0,1239,1272
16012,11,3,18,0,1240,1251
17591,38,3,19,0,1240,1278
52035,38,2,19,0,1240,1278
126969,8,2,18,0,1240,1248
87405,32,2,19,0,1241,1273
106976,35,2,19,0,1241,1276
122087,14,3,18,0,1241,1255
113211,13,3,18,0,1242,1255
125035,13,4,18,0,1242,1255
11652,32,2,19,0,1243,1275
17388,32,6,19,0,1243,1275
38259,32,2,19,0,1243,1275
44619,32,2,19,0,1243,1275
46659,32,2,19,0,1243,1275
50486,32,2,19,0,1243,1275
60510,32,2,19,0,1243,1275
70755,10,3,18,0,1243,1253
85116,35,3,19,0,1243,1278
107038,32,2,19,0,1243,1275
111890,16,1,18,0,1243,1259
118549,11,1,18,0,1243,1254
128060,32,2,19,0,1243,1275
20893,34,4,19,0,1244,1278
60574,13,1,18,0,1244,1257
90375,31,3,19,0,1244,1275
113688,34,4,19,0,1244,1278
123816,21,3,19,0,1244,1265
59119,7,2,18,0,1245,1252
63063,7,3,18,0,1245,1252
89747,10,1,18,0,1245,1255
95126,28,2,19,0,1245,1273
95428,9,4,18,0,1245,1254
113140,7,10,18,0,1245,1252
127944,7,2,18,0,1245,1252
6612,11,3,18,0,1246,1257
7015,9,1,18,0,1246,1255
8579,9,1,18,0,1246,1255
48375,28,1,19,0,1246,1274
86936,8,4,18,0,1246,1254
88018,9,1,18,0,1246,1255
118051,8,1,18,0,1246,1254
121434,10,8,18,0,1246,1256
122336,9,7,18,0,1246,1255
10138,28,3,19,0,1247,1275
12379,15,6,19,0,1247,1262
77015,4,3,18,0,1247,1251
90071,17,4,19,0,1247,1264
114366,15,3,19,0,1247,1262
9265,2,5,18,0,1248,1250
21255,6,4,18,0,1248,1254
33744,22,2,19,0,1248,1270
37268,4,1,18,0,1248,1252
74697,3,6,18,0,1248,1251
75072,28,8,19,0,1248,1276
102997,30,8,19,0,1248,1278
105072,3,2,18,0,1248,1251
118866,6,5,18,0,1248,1254
123387,3,2,18,0,1248,1251
6296,18,1,19,0,1249,1267
40673,18,2,19,0,1249,1267
40779,4,8,18,0,1249,1253
49802,18,2,19,1,1249,1267
51877,29,3,19,0,1249,1278
66494,8,2,18,0,1249,1257
98190,18,2,19,0,1249,1267
115565,18,2,19,0,1249,1267
9399,6,2,18,0,1250,1256
16719,3,5,18,0,1250,1253
19099,12,4,19,0,1250,1262
20309,6,2,18,0,1250,1256
48435,16,1,19,0,1250,1266
70463,16,1,19,0,1250,1266
74854,3,2,18,0,1250,1253
84787,25,4,19,0,1250,1275
90914,2,4,18,0,1250,1252
93999,6,2,18,0,1250,1256
101552,16,2,19,0,1250,1266
113871,16,2,19,0,1250,1266
119705,28,3,19,0,1250,1278
124193,14,4,19,0,1250,1264
128260,16,1,19,0,1250,1266
33643,11,2,19,0,1251,1262
56687,27,3,19,0,1251,1278
28794,26,3,19,0,1252,1278
35704,3,4,18,0,1252,1255
112667,2,2,18,0,1252,1254
7113,10,3,19,0,1253,1263
17402,10,4,19,0,1253,1263
18221,10,3,19,0,1253,1263
30902,10,3,19,0,1253,1263
31056,10,3,19,0,1253,1263
34109,10,3,19,0,1253,1263
48750,10,3,19,0,1253,1263
78532,10,3,19,0,1253,1263
81084,10,3,19,0,1253,1263
84677,10,3,19,0,1253,1263
106454,10,3,19,0,1253,1263
107460,10,3,19,0,1253,1263
112208,9,5,19,0,1253,1262
122464,10,5,19,0,1253,1263
45259,5,3,19,0,1255,1260
112521,21,2,19,0,1255,1276
127084,7,4,19,0,1255,1262
29938,4,2,19,0,1257,1261
88713,4,3,19,0,1257,1261
94840,19,2,19,0,1259,1278
118866,19,6,19,0,1259,1278
16625,15,2,19,0,1260,1275
61989,18,4,19,0,1260,1278
66277,9,3,19,0,1260,1269
54974,17,8,19,0,1261,1278
127553,11,3,19,0,1261,1272
25306,14,2,19,0,1262,1276
70755,13,4,19,0,1262,1275
75053,13,3,19,0,1262,1275
92870,13,2,19,0,1262,1275
122201,9,2,19,0,1262,1271
21468,7,3,19,0,1263,1270
71122,12,3,19,0,1263,1275
77749,12,4,19,0,1263,1275
86816,14,6,19,0,1263,1277
123636,16,3,19,0,1263,1279
24096,11,2,19,0,1264,1275
31190,10,2,19,0,1264,1274
37215,11,6,19,0,1264,1275
44985,11,5,19,0,1264,1275
71812,10,6,19,0,1264,1274
125035,4,5,19,0,1264,1268
126774,11,4,19,0,1264,1275
129534,11,6,19,0,1264,1275
15206,10,4,19,0,1265,1275
17053,11,4,19,0,1265,1276
41494,11,2,19,0,1265,1276
127944,3,3,19,0,1265,1268
35704,8,5,19,0,1267,1275
47076,10,2,19,0,1268,1278
51415,7,4,19,0,1268,1275
129385,10,1,19,0,1268,1278
18221,5,4,19,0,1269,1274
